Timestamp,duration,left_sensor1,left_sensor2,left_sensor3,left_sensor4,left_sensor5,right_sensor1,right_sensor2,right_sensor3,right_sensor4,right_sensor5,left_stride_F,left_balance_x,left_balance_y,right_stride_F,right_balance_x,right_balance_y,body_COP_x,body_COP_y
16:00.0,0,429,375,502,471,389,384,191,405,374,48,435,127,46,326,214,278,-546,325
16:00.0,0,435,385,507,478,398,384,191,405,374,48,442,122,44,326,214,278,-569,323
16:00.0,0,435,385,507,478,398,318,117,400,312,19,442,122,44,278,283,259,-709,303
16:00.0,0,442,397,520,490,408,318,117,400,312,19,453,123,45,278,283,259,-741,304
16:00.1,0,442,397,520,490,408,246,61,358,193,4,453,123,45,221,297,217,-932,262
16:00.1,0,452,409,535,502,422,246,61,358,193,4,465,126,43,221,297,217,-970,261
16:00.1,0,452,409,535,502,422,169,23,266,24,6,465,126,43,152,243,146,-1206,190
16:00.1,0,458,418,557,508,440,169,23,266,24,6,477,139,37,152,243,146,-1243,184
16:00.1,0,458,418,557,508,440,79,19,106,0,3,477,139,37,68,87,65,-1354,102
16:00.2,0,462,422,569,509,453,79,19,106,0,3,484,147,31,68,87,65,-1375,96
16:00.2,0,462,422,569,509,453,46,15,35,0,3,484,147,31,32,20,29,-1411,60
16:00.2,0,462,424,578,508,459,46,15,35,0,3,488,154,29,32,20,29,-1420,58
16:00.2,0,462,424,578,508,459,15,2,12,0,4,488,154,29,9,10,5,-1441,34
16:00.2,0,462,425,586,509,462,15,2,12,0,4,491,161,29,9,10,5,-1448,34
16:00.3,0,462,425,586,509,462,6,0,1,0,3,491,161,29,2,1,0,-1456,28
16:00.3,0,459,425,595,506,465,6,0,1,0,3,493,170,28,2,1,0,-1458,27
16:00.3,0,459,425,595,506,465,4,0,0,0,3,493,170,28,1,0,-1,-1459,26
16:00.3,0,454,414,600,499,473,4,0,0,0,3,489,186,16,1,0,-1,-1457,14
16:00.3,0,454,414,600,499,473,5,0,0,0,3,489,186,16,1,0,-1,-1456,15
16:00.4,0,439,394,601,491,487,5,0,0,0,3,478,207,-9,1,0,-1,-1451,-10
16:00.4,0,439,394,601,491,487,4,0,0,0,6,478,207,-9,1,0,-4,-1448,-13
16:00.4,0,439,394,601,491,487,4,0,0,0,7,478,207,-9,1,0,-5,-1447,-14
16:00.5,0,430,383,599,487,500,4,0,0,0,7,470,216,-29,1,0,-5,-1449,-35
16:00.5,0,429,382,601,487,503,4,0,0,0,7,470,219,-32,1,0,-5,-1452,-38
16:00.5,0,429,382,601,487,503,4,0,0,0,7,470,219,-32,1,0,-5,-1452,-38
16:00.5,0,429,382,601,487,503,4,0,0,0,6,470,219,-32,1,0,-4,-1453,-37
16:00.5,0,428,381,603,481,503,4,0,0,0,6,470,222,-32,1,0,-4,-1447,-37
16:00.6,1,428,381,603,481,503,5,0,0,0,6,470,222,-32,1,0,-4,-1447,-36
16:00.6,1,428,383,608,480,499,5,0,0,0,6,473,225,-26,1,0,-4,-1444,-30
16:00.6,1,440,392,615,487,486,5,0,0,0,6,482,223,-3,1,0,-4,-1447,-8
16:00.6,1,440,392,615,487,486,5,0,0,0,7,482,223,-3,1,0,-5,-1446,-9
16:00.7,1,460,406,621,498,453,5,0,0,0,7,495,215,42,1,0,-5,-1438,37
16:00.7,1,460,406,621,498,453,5,0,0,0,7,495,215,42,1,0,-5,-1438,37
16:00.7,1,477,433,627,508,373,5,0,0,0,7,512,194,139,1,0,-5,-1384,134
16:00.7,1,477,433,627,508,373,0,0,0,0,6,512,194,139,0,0,-6,-1387,133
16:00.8,1,504,462,633,516,181,0,0,0,0,6,533,171,352,0,0,-6,-1224,346
16:00.8,1,504,462,633,516,181,0,0,0,0,37,533,171,352,0,0,-37,-1193,315
16:00.8,1,504,462,633,516,181,0,0,0,0,186,533,171,352,0,0,-186,-1044,166
16:00.8,1,538,480,639,516,33,0,0,0,0,186,552,159,519,0,0,-186,-915,333
16:00.9,1,538,480,639,516,33,0,0,8,0,329,552,159,519,2,8,-326,-769,193
16:00.9,1,565,493,645,495,4,0,0,8,0,329,567,152,563,2,8,-326,-734,237
16:00.9,1,586,488,646,377,0,0,0,8,0,329,573,158,573,2,8,-326,-618,247
16:00.9,1,586,488,646,377,0,11,3,35,126,394,573,158,573,16,32,-377,-414,195
16:00.9,1,595,445,629,194,0,11,3,35,126,394,556,184,556,16,32,-377,-214,178
16:00.9,1,595,445,629,194,0,71,27,103,240,442,556,184,556,67,76,-375,-1,181
16:01.0,1,594,367,579,95,0,71,27,103,240,442,513,212,513,67,76,-375,140,138
16:01.0,1,594,367,579,95,0,99,34,139,292,477,513,212,513,90,105,-386,251,127
16:01.1,1,586,294,562,42,0,99,34,139,292,477,480,268,480,90,105,-386,337,94
16:01.1,1,586,294,562,42,0,112,80,160,314,510,480,268,480,117,80,-392,418,88
16:01.1,1,569,195,556,33,0,112,80,160,314,510,440,361,440,117,80,-392,468,47
16:01.1,1,569,195,556,33,0,157,120,192,352,534,440,361,440,156,72,-377,569,62
16:01.1,1,569,195,556,33,0,224,186,235,402,552,440,361,440,215,49,-337,696,103
16:01.2,1,519,135,522,24,0,224,186,235,402,552,392,387,392,215,49,-337,753,55
16:01.2,1,376,76,448,6,0,224,186,235,402,552,300,372,300,215,49,-337,863,-37
16:01.2,1,376,76,448,6,0,277,227,314,473,557,300,372,300,272,87,-284,996,15
16:01.2,1,376,76,448,6,0,321,273,404,507,553,300,372,300,332,131,-220,1086,79
16:01.2,1,216,41,175,7,0,321,273,404,507,553,144,134,144,332,131,-220,1241,-76
16:01.3,1,9,11,1,6,0,321,273,404,507,553,7,-10,7,332,131,-220,1379,-213
16:01.3,1,9,11,1,6,0,339,228,454,537,530,7,-10,7,340,226,-189,1394,-182
16:01.3,1,9,11,1,6,0,354,217,486,553,489,7,-10,7,352,269,-136,1381,-129
16:01.3,1,10,0,0,4,0,354,217,486,553,489,3,0,3,352,269,-136,1387,-133
16:01.4,1,1,0,0,4,0,354,217,486,553,489,0,0,0,352,269,-136,1390,-136
16:01.4,1,1,0,0,4,0,392,287,507,561,453,0,0,0,395,220,-57,1405,-57
16:01.4,1,1,0,0,4,0,426,345,526,564,414,0,0,0,432,181,18,1406,18
16:01.4,1,0,6,0,6,0,426,345,526,564,414,2,-6,2,432,181,18,1402,20
16:01.4,1,4,9,0,5,0,426,345,526,564,414,4,-9,4,432,181,18,1401,22
16:01.5,1,4,9,0,5,0,449,382,547,571,368,4,-9,4,459,165,91,1389,95
16:01.5,1,4,9,0,5,0,459,399,563,579,318,4,-9,4,473,164,155,1361,160
16:01.5,1,10,9,0,6,0,459,399,563,579,318,6,-9,6,473,164,155,1358,162
16:01.5,1,8,10,0,5,0,459,399,563,579,318,6,-10,6,473,164,155,1359,161
16:01.5,1,8,10,0,5,0,457,389,577,588,225,6,-10,6,474,188,249,1276,255
16:01.6,2,8,10,0,5,0,442,394,589,592,152,6,-10,6,475,195,323,1208,329
16:01.6,2,4,11,0,5,0,442,394,589,592,152,5,-11,5,475,195,323,1209,328
16:01.6,2,0,9,0,6,0,442,394,589,592,152,3,-9,3,475,195,323,1210,326
16:01.6,2,0,9,0,6,0,431,408,598,596,87,3,-9,3,479,190,392,1153,395
16:01.7,2,0,9,0,6,0,432,429,606,596,33,3,-9,3,489,177,456,1109,459
16:01.7,2,0,7,0,1,0,432,429,606,596,33,2,-7,2,489,177,456,1114,458
16:01.7,2,0,7,0,1,0,458,456,612,591,24,2,-7,2,508,156,484,1120,487
16:01.7,2,0,5,0,6,0,458,456,612,591,24,1,-5,1,508,156,484,1116,486
16:01.8,2,0,5,0,6,0,491,482,619,573,17,1,-5,1,530,137,513,1112,515
16:01.8,2,0,7,0,11,0,491,482,619,573,17,2,-7,2,530,137,513,1107,516
16:01.8,2,0,7,0,11,0,521,503,625,534,8,2,-7,2,549,122,541,1078,544
16:01.8,2,0,7,0,11,0,545,505,627,390,7,2,-7,2,559,122,552,942,554
16:01.9,2,0,3,4,11,211,545,505,627,390,7,2,1,-208,559,122,552,731,343
16:01.9,2,0,8,28,20,413,545,505,627,390,7,12,20,-401,559,122,552,511,151
16:01.9,2,0,8,28,20,413,562,472,619,127,3,12,20,-401,551,147,548,236,147
16:01.9,2,0,14,197,92,473,562,472,619,127,3,70,183,-402,551,147,548,45,145
16:01.9,2,0,14,197,92,473,562,428,567,0,5,70,183,-402,519,139,514,-111,111
16:02.0,2,89,73,462,204,495,562,428,567,0,5,208,389,-287,519,139,514,-383,227
16:02.0,2,89,73,462,204,495,547,402,444,0,10,208,389,-287,464,42,454,-432,167
16:02.0,2,311,95,547,231,516,547,402,444,0,10,317,452,-198,464,42,454,-590,256
16:02.0,2,311,95,547,231,516,419,371,318,0,10,317,452,-198,369,-53,359,-685,161
16:02.1,2,394,156,580,300,530,419,371,318,0,10,376,424,-153,369,-53,359,-827,206
16:02.1,2,394,156,580,300,530,203,188,144,0,12,376,424,-153,178,-44,166,-1016,13
16:02.1,2,444,206,598,363,533,203,188,144,0,12,416,392,-117,178,-44,166,-1121,49
16:02.1,2,444,206,598,363,533,25,28,8,0,11,416,392,-117,20,-20,9,-1280,-107
16:02.1,2,472,255,612,399,525,25,28,8,0,11,446,357,-78,20,-20,9,-1339,-69
16:02.2,2,472,255,612,399,525,0,0,0,0,2,446,357,-78,0,0,-2,-1368,-80
16:02.2,2,485,291,625,420,507,0,0,0,0,2,467,334,-40,0,0,-2,-1392,-42
16:02.2,2,485,291,625,420,507,0,0,0,0,1,467,334,-40,0,0,-1,-1393,-41
16:02.2,2,497,312,631,432,480,0,0,0,0,1,480,319,0,0,0,-1,-1391,-1
16:02.3,2,497,312,631,432,480,0,0,0,0,1,480,319,0,0,0,-1,-1391,-1
16:02.3,2,504,333,638,439,447,0,0,0,0,1,491,305,44,0,0,-1,-1376,43
16:02.3,2,504,333,638,439,447,2,0,0,0,1,491,305,44,0,0,0,-1376,44
16:02.3,2,504,333,638,439,447,7,0,0,0,1,491,305,44,2,0,1,-1374,46
16:02.4,2,503,358,647,443,420,7,0,0,0,1,502,289,82,2,0,1,-1362,84
16:02.4,2,526,374,653,452,366,7,0,0,0,1,517,279,151,2,0,1,-1332,153
16:02.4,2,526,374,653,452,366,21,0,0,0,0,517,279,151,7,0,7,-1328,158
16:02.4,2,526,374,653,452,366,36,0,0,0,0,517,279,151,12,0,12,-1323,163
16:02.5,2,551,388,661,455,247,36,0,0,0,0,533,273,286,12,0,12,-1223,298
16:02.5,2,575,402,673,454,133,36,0,0,0,0,550,271,417,12,0,12,-1125,429
16:02.5,2,575,402,673,454,133,37,0,0,0,1,550,271,417,12,0,11,-1123,428
16:02.5,2,593,411,687,440,35,37,0,0,0,1,563,276,528,12,0,11,-1025,540
16:02.5,2,593,411,687,440,35,33,0,0,0,1,563,276,528,11,0,10,-1026,538
16:02.5,2,613,418,698,400,6,33,0,0,0,1,576,280,570,11,0,10,-970,580
16:02.6,3,613,418,698,400,6,18,0,0,0,0,576,280,570,6,0,6,-976,576
16:02.6,3,628,417,707,303,0,18,0,0,0,0,584,290,584,6,0,6,-881,590
16:02.6,3,628,417,707,303,0,8,0,0,0,118,584,290,584,2,0,-115,-766,468
16:02.6,3,639,411,713,180,0,8,0,0,0,118,587,302,587,2,0,-115,-647,472
16:02.7,3,639,411,713,180,0,0,0,17,0,430,587,302,587,5,17,-424,-331,163
16:02.7,3,648,337,709,64,0,0,0,17,0,430,564,372,564,5,17,-424,-192,140
16:02.7,3,648,337,709,64,0,0,0,73,137,536,564,372,564,24,73,-511,68,53
16:02.7,3,648,155,665,3,0,0,0,73,137,536,489,510,489,24,73,-511,205,-22
16:02.8,3,648,155,665,3,0,0,1,151,331,538,489,510,489,50,150,-487,427,2
16:02.8,3,625,52,593,0,0,0,1,151,331,538,423,541,423,50,150,-487,496,-64
16:02.8,3,625,52,593,0,0,0,16,200,380,562,423,541,423,72,184,-490,590,-66
16:02.8,3,511,31,553,0,0,0,16,200,380,562,365,522,365,72,184,-490,649,-125
16:02.9,3,511,31,553,0,0,0,28,243,421,579,365,522,365,90,215,-488,725,-123
16:02.9,3,324,15,433,0,0,0,28,243,421,579,257,418,257,90,215,-488,833,-231
16:02.9,3,324,15,433,0,0,0,43,301,479,587,257,418,257,114,258,-472,923,-215
16:02.9,3,158,9,98,0,0,0,43,301,479,587,88,89,88,114,258,-472,1092,-384
16:03.0,3,158,9,98,0,0,1,67,352,511,596,88,89,88,140,285,-456,1158,-367
16:03.0,3,31,0,0,0,0,1,67,352,511,596,10,0,10,140,285,-456,1236,-445
16:03.0,3,31,0,0,0,0,2,73,391,531,587,10,0,10,155,318,-431,1263,-421
16:03.0,3,42,0,0,0,0,2,73,391,531,587,14,0,14,155,318,-431,1259,-417
16:03.1,3,42,0,0,0,0,3,60,423,545,572,14,0,14,162,363,-410,1265,-396
16:03.1,3,34,0,0,0,0,3,60,423,545,572,11,0,11,162,363,-410,1267,-398
16:03.1,3,34,0,0,0,0,8,118,449,554,561,11,0,11,191,331,-369,1295,-358
16:03.1,3,45,0,0,0,0,8,118,449,554,561,15,0,15,191,331,-369,1291,-354
16:03.1,3,45,0,0,0,0,51,197,473,560,553,15,0,15,240,276,-312,1338,-297
16:03.2,3,59,0,0,3,0,51,197,473,560,553,19,0,19,240,276,-312,1330,-293
16:03.2,3,59,0,0,3,0,130,284,488,564,532,19,0,19,300,204,-231,1374,-211
16:03.2,3,73,1,0,3,0,130,284,488,564,532,24,-1,24,300,204,-231,1369,-206
16:03.2,3,73,1,0,3,0,207,352,504,568,494,24,-1,24,354,152,-139,1388,-115
16:03.2,3,100,0,0,4,0,207,352,504,568,494,33,0,33,354,152,-139,1379,-106
16:03.2,3,100,0,0,4,0,279,399,527,571,449,33,0,33,401,128,-47,1384,-14
16:03.3,3,80,0,0,0,0,279,399,527,571,449,26,0,26,401,128,-47,1395,-20
16:03.3,3,80,0,0,0,0,334,443,542,565,399,26,0,26,439,99,40,1377,67
16:03.3,3,53,0,0,0,0,334,443,542,565,399,17,0,17,439,99,40,1386,58
16:03.3,3,53,0,0,0,0,395,502,547,553,326,17,0,17,481,45,155,1342,173
16:03.4,3,43,1,0,0,0,395,502,547,553,326,14,-1,14,481,45,155,1345,170
16:03.4,3,43,1,0,0,0,468,550,553,533,204,14,-1,14,523,3,319,1245,334
16:03.4,3,43,1,0,0,0,542,584,561,496,82,14,-1,14,562,-23,480,1125,495
16:03.5,3,17,0,3,1,0,542,584,561,496,82,6,3,6,562,-23,480,1132,487
16:03.5,3,17,0,3,1,0,591,607,568,415,41,6,3,6,588,-39,547,1036,554
16:03.5,3,0,2,0,3,290,591,607,568,415,41,0,-2,-289,588,-39,547,750,258
16:03.5,3,0,11,0,26,484,591,607,568,415,41,3,-11,-480,588,-39,547,530,67
16:03.6,4,0,11,0,26,484,617,619,546,55,16,3,-11,-480,594,-73,578,151,97
16:03.6,4,0,35,2,150,546,617,619,546,55,16,12,-33,-533,594,-73,578,-43,44
16:03.6,4,0,35,2,150,546,624,584,430,0,6,12,-33,-533,546,-154,540,-156,6
16:03.6,4,0,35,2,150,546,596,526,263,0,7,12,-33,-533,461,-263,454,-239,-79
16:03.6,4,1,86,29,299,575,596,526,263,0,7,38,-57,-536,461,-263,454,-444,-81
16:03.7,4,4,152,45,375,592,596,526,263,0,7,67,-107,-525,461,-263,454,-565,-70
16:03.7,4,4,152,45,375,592,406,413,78,0,8,67,-107,-525,299,-335,291,-727,-234
16:03.7,4,4,152,45,375,592,114,99,0,0,5,67,-107,-525,71,-99,66,-958,-459
16:03.7,4,7,210,35,434,602,114,99,0,0,5,84,-175,-518,71,-99,66,-1044,-452
16:03.8,4,10,258,33,480,603,114,99,0,0,5,100,-225,-502,71,-99,66,-1107,-436
16:03.8,4,10,258,33,480,603,0,7,0,0,5,100,-225,-502,2,-7,-2,-1176,-505
16:03.8,4,14,301,30,522,593,0,7,0,0,5,115,-271,-478,2,-7,-2,-1222,-480
16:03.8,4,14,301,30,522,593,0,4,0,0,4,115,-271,-478,1,-4,-2,-1224,-480
16:03.8,4,18,346,30,547,577,0,4,0,0,4,131,-316,-445,1,-4,-2,-1250,-448
16:03.9,4,18,346,30,547,577,0,5,0,0,3,131,-316,-445,1,-5,-1,-1250,-447
16:03.9,4,23,380,32,564,561,0,5,0,0,3,145,-348,-416,1,-5,-1,-1265,-417
16:03.9,4,23,380,32,564,561,0,0,0,0,3,145,-348,-416,0,0,-3,-1267,-419
16:03.9,4,26,406,51,575,548,0,0,0,0,3,161,-355,-387,0,0,-3,-1281,-390
16:03.9,4,26,406,51,575,548,2,0,0,0,3,161,-355,-387,0,0,-2,-1280,-389
16:04.0,4,31,427,72,586,527,2,0,0,0,3,176,-355,-350,0,0,-2,-1285,-352
16:04.0,4,31,427,72,586,527,5,0,0,0,3,176,-355,-350,1,0,-1,-1284,-351
16:04.0,4,36,447,97,596,497,5,0,0,0,3,193,-350,-303,1,0,-1,-1281,-305
16:04.0,4,36,447,97,596,497,7,0,0,0,0,193,-350,-303,2,0,2,-1284,-301
16:04.1,4,46,469,135,604,443,7,0,0,0,0,216,-334,-226,2,0,2,-1261,-224
16:04.1,4,46,469,135,604,443,10,0,0,0,2,216,-334,-226,3,0,1,-1258,-225
16:04.1,4,92,503,234,608,345,10,0,0,0,2,276,-269,-68,3,0,1,-1224,-67
16:04.1,4,92,503,234,608,345,9,0,0,0,4,276,-269,-68,3,0,-1,-1222,-69
16:04.2,4,202,527,374,608,198,9,0,0,0,4,367,-153,169,3,0,-1,-1166,168
16:04.2,4,202,527,374,608,198,8,0,0,0,2,367,-153,169,2,0,0,-1169,170
16:04.2,4,330,550,450,608,77,8,0,0,0,2,443,-100,366,2,0,0,-1123,367
16:04.2,4,330,550,450,608,77,7,0,0,0,2,443,-100,366,2,0,0,-1124,366
16:04.3,4,429,565,530,603,20,7,0,0,0,2,508,-35,488,2,0,0,-1126,488
16:04.3,4,429,565,530,603,20,0,0,0,0,0,508,-35,488,0,0,0,-1131,488
16:04.3,4,429,565,530,603,20,0,0,0,0,249,508,-35,488,0,0,-249,-882,239
16:04.3,4,525,574,574,572,0,0,0,0,0,249,557,0,557,0,0,-249,-880,308
16:04.4,4,566,571,585,382,0,0,0,0,0,249,574,14,574,0,0,-249,-707,325
16:04.4,4,566,571,585,382,0,0,0,28,0,450,574,14,574,9,28,-440,-496,133
16:04.4,4,566,571,585,382,0,1,0,88,248,485,574,14,574,29,88,-455,-193,118
16:04.4,4,576,511,552,204,0,1,0,88,248,485,546,41,546,29,88,-455,12,91
16:04.4,4,546,389,519,45,0,1,0,88,248,485,484,130,484,29,88,-455,233,29
16:04.5,4,546,389,519,45,0,7,8,180,348,536,484,130,484,65,172,-471,419,13
16:04.5,4,546,389,519,45,0,22,20,275,459,557,484,130,484,105,255,-451,591,33
16:04.5,4,313,277,471,29,0,22,20,275,459,557,353,194,353,105,255,-451,738,-97
16:04.5,4,143,133,213,12,0,22,20,275,459,557,163,80,163,105,255,-451,946,-288
16:04.6,5,143,133,213,12,0,54,23,391,532,566,163,80,163,156,368,-410,1079,-247
16:04.6,5,143,133,213,12,0,65,25,433,557,572,163,80,163,174,408,-397,1128,-234
16:04.6,5,17,36,0,12,0,65,25,433,557,572,17,-36,17,174,408,-397,1273,-380
16:04.6,5,21,5,0,2,0,65,25,433,557,572,8,-5,8,174,408,-397,1292,-389
16:04.6,5,21,5,0,2,0,52,36,452,564,568,8,-5,8,180,416,-388,1301,-379
16:04.7,5,21,5,0,2,0,18,112,454,558,569,8,-5,8,194,342,-374,1310,-365
16:04.7,5,17,7,0,3,0,18,112,454,558,569,8,-7,8,194,342,-374,1310,-366
16:04.7,5,21,7,0,1,0,18,112,454,558,569,9,-7,9,194,342,-374,1311,-365
16:04.7,5,21,7,0,1,0,14,192,454,553,569,9,-7,9,220,262,-349,1331,-339
16:04.8,5,21,7,0,1,0,58,280,462,552,560,9,-7,9,266,182,-293,1368,-284
16:04.8,5,36,8,0,1,0,58,280,462,552,560,14,-8,14,266,182,-293,1363,-278
16:04.8,5,53,11,0,4,0,58,280,462,552,560,21,-11,21,266,182,-293,1353,-272
16:04.8,5,53,11,0,4,0,158,353,473,554,529,21,-11,21,328,120,-201,1385,-179
16:04.8,5,53,11,0,4,0,252,405,505,561,475,21,-11,21,387,100,-87,1398,-66
16:04.9,5,80,13,0,4,0,252,405,505,561,475,31,-13,31,387,100,-87,1388,-56
16:04.9,5,80,13,0,4,0,344,451,534,564,393,31,-13,31,443,83,50,1365,81
16:04.9,5,93,12,0,5,0,344,451,534,564,393,35,-12,35,443,83,50,1360,85
16:04.9,5,93,12,0,5,0,430,507,559,563,245,35,-12,35,498,52,253,1266,288
16:04.9,5,92,13,0,11,0,430,507,559,563,245,35,-13,35,498,52,253,1260,288
16:05.0,5,92,13,0,11,0,520,557,578,555,80,35,-13,35,551,21,471,1140,506
16:05.0,5,36,16,2,18,0,520,557,578,555,80,18,-14,18,551,21,471,1150,489
16:05.0,5,36,16,2,18,0,574,587,591,482,40,18,-14,18,584,4,544,1070,562
16:05.0,5,0,10,0,22,264,574,587,591,482,40,3,-10,-260,584,4,544,816,283
16:05.1,5,0,10,0,22,264,598,590,594,173,5,3,-10,-260,594,4,589,482,328
16:05.1,5,0,36,21,62,528,598,590,594,173,5,19,-15,-509,594,4,589,163,80
16:05.1,5,1,71,161,224,570,598,590,594,173,5,77,90,-492,594,4,589,-99,96
16:05.1,5,1,71,161,224,570,597,519,521,0,4,77,90,-492,545,2,541,-322,49
16:05.2,5,1,71,161,224,570,515,448,371,0,8,77,90,-492,444,-77,436,-419,-55
16:05.2,5,106,168,360,292,584,515,448,371,0,8,211,192,-372,444,-77,436,-634,64
16:05.2,5,189,223,429,361,594,515,448,371,0,8,280,206,-313,444,-77,436,-782,123
16:05.2,5,189,223,429,361,594,265,299,177,0,9,280,206,-313,247,-122,238,-979,-75
16:05.3,5,189,223,429,361,594,38,57,12,0,6,280,206,-313,35,-45,29,-1193,-284
16:05.3,5,189,270,450,405,599,38,57,12,0,6,303,180,-296,35,-45,29,-1265,-266
16:05.3,5,145,278,471,411,601,38,57,12,0,6,298,193,-303,35,-45,29,-1268,-273
16:05.3,5,145,278,471,411,601,0,0,0,0,5,298,193,-303,0,0,-5,-1305,-308
16:05.4,5,145,278,471,411,601,0,0,0,0,4,298,193,-303,0,0,-4,-1306,-307
16:05.4,5,119,236,482,387,604,0,0,0,0,4,279,246,-325,0,0,-4,-1266,-329
16:05.4,5,117,217,510,369,602,0,0,0,0,4,281,293,-320,0,0,-4,-1248,-324
16:05.4,5,117,217,510,369,602,0,0,0,0,4,281,293,-320,0,0,-4,-1248,-324
16:05.4,5,117,217,510,369,602,0,0,0,0,3,281,293,-320,0,0,-3,-1249,-323
16:05.5,5,144,243,541,386,596,0,0,0,0,3,309,298,-286,0,0,-3,-1288,-289
16:05.5,5,172,272,566,404,587,0,0,0,0,3,336,294,-250,0,0,-3,-1324,-253
16:05.5,5,172,272,566,404,587,2,0,0,0,3,336,294,-250,0,0,-2,-1324,-252
16:05.5,5,172,272,566,404,587,11,0,0,0,3,336,294,-250,3,0,0,-1321,-249
16:05.6,6,209,308,591,427,570,11,0,0,0,3,369,283,-200,3,0,0,-1359,-200
16:05.6,6,263,338,610,441,533,11,0,0,0,3,403,272,-129,3,0,0,-1371,-128
16:05.6,6,263,338,610,441,533,17,0,0,0,4,403,272,-129,5,0,1,-1368,-127
16:05.6,6,263,338,610,441,533,20,0,0,0,3,403,272,-129,6,0,3,-1368,-125
16:05.6,6,338,380,630,451,472,20,0,0,0,3,449,250,-22,6,0,3,-1362,-19
16:05.7,6,338,380,630,451,472,9,0,0,0,3,449,250,-22,3,0,0,-1366,-22
16:05.7,6,403,404,644,457,322,9,0,0,0,3,483,240,161,3,0,0,-1256,161
16:05.7,6,403,404,644,457,322,9,0,0,0,3,483,240,161,3,0,0,-1256,161
16:05.7,6,499,436,665,462,118,9,0,0,0,3,533,229,415,3,0,0,-1107,415
16:05.8,6,499,436,665,462,118,0,0,0,0,2,533,229,415,0,0,-2,-1111,413
16:05.8,6,576,457,683,428,34,0,0,0,0,2,572,226,538,0,0,-2,-1032,536
16:05.8,6,576,457,683,428,34,0,0,0,0,0,572,226,538,0,0,0,-1034,538
16:05.8,6,615,463,695,269,0,0,0,0,0,0,591,232,591,0,0,0,-860,591
16:05.9,6,615,463,695,269,0,0,0,13,0,352,591,232,591,4,13,-347,-503,243
16:05.9,6,615,463,695,269,0,0,0,65,69,539,591,232,591,21,65,-517,-230,73
16:05.9,6,630,413,696,103,0,0,0,65,69,539,579,283,579,21,65,-517,-53,62
16:05.9,6,634,249,646,13,0,0,0,65,69,539,509,397,509,21,65,-517,106,-7
16:06.0,6,634,249,646,13,0,0,21,162,319,554,509,397,509,61,141,-493,411,16
16:06.0,6,610,101,593,0,0,0,21,162,319,554,434,492,434,61,141,-493,499,-58
16:06.0,6,610,101,593,0,0,7,42,224,375,582,434,492,434,91,182,-491,613,-56
16:06.0,6,360,52,531,0,0,7,42,224,375,582,314,479,314,91,182,-491,733,-176
16:06.0,6,360,52,531,0,0,24,88,267,428,600,314,479,314,126,179,-473,840,-159
16:06.1,6,189,32,201,0,0,24,88,267,428,600,140,169,140,126,179,-473,1013,-333
16:06.1,6,189,32,201,0,0,31,102,310,467,605,140,169,140,147,208,-457,1078,-316
16:06.1,6,12,5,0,0,0,31,102,310,467,605,5,-5,5,147,208,-457,1213,-451
16:06.2,6,38,0,0,0,0,31,102,310,467,605,12,0,12,147,208,-457,1206,-444
16:06.2,6,38,0,0,0,0,28,83,326,489,612,12,0,12,145,243,-466,1233,-453
16:06.2,6,38,0,0,0,0,19,84,346,503,611,12,0,12,149,262,-461,1250,-448
16:06.2,6,15,0,1,0,0,19,84,346,503,611,5,1,5,149,262,-461,1258,-456
16:06.2,6,15,0,1,0,0,7,128,371,511,603,5,1,5,168,243,-434,1277,-429
16:06.2,6,15,0,0,0,0,7,128,371,511,603,5,0,5,168,243,-434,1277,-429
16:06.3,6,15,0,0,0,0,17,220,407,517,590,5,0,5,214,187,-375,1316,-370
16:06.3,6,24,0,0,0,0,17,220,407,517,590,8,0,8,214,187,-375,1313,-367
16:06.3,6,24,0,0,0,0,86,309,439,530,571,8,0,8,278,130,-293,1371,-285
16:06.3,6,41,1,0,0,0,86,309,439,530,571,14,-1,14,278,130,-293,1365,-279
16:06.3,6,41,1,0,0,0,206,389,469,544,531,14,-1,14,354,80,-176,1415,-162
16:06.4,6,51,0,0,0,0,206,389,469,544,531,17,0,17,354,80,-176,1412,-159
16:06.4,6,51,0,0,0,0,319,439,501,553,455,17,0,17,419,62,-35,1410,-18
16:06.4,6,54,3,0,0,0,319,439,501,553,455,19,-3,19,419,62,-35,1408,-16
16:06.4,6,54,3,0,0,0,405,496,541,558,336,19,-3,19,480,45,144,1355,163
16:06.5,7,44,5,0,0,0,405,496,541,558,336,16,-5,16,480,45,144,1358,161
16:06.5,7,44,5,0,0,0,494,542,568,554,152,16,-5,16,534,26,382,1224,399
16:06.5,7,19,4,0,3,0,494,542,568,554,152,7,-4,7,534,26,382,1229,390
16:06.5,7,19,4,0,3,0,565,584,586,512,51,7,-4,7,578,2,527,1130,535
16:06.6,7,0,4,4,5,160,565,584,586,512,51,2,0,-157,578,2,527,973,370
16:06.6,7,0,4,4,5,160,607,610,592,377,30,2,0,-157,603,-18,573,842,415
16:06.6,7,0,15,3,12,470,607,610,592,377,30,6,-12,-464,603,-18,573,522,109
16:06.7,7,0,15,3,12,470,632,619,568,0,5,6,-12,-464,606,-51,601,123,137
16:06.7,7,0,59,33,105,582,632,619,568,0,5,30,-26,-551,606,-51,601,-106,50
16:06.7,7,0,59,33,105,582,642,572,425,0,5,30,-26,-551,546,-147,541,-166,-10
16:06.7,7,0,117,96,337,592,642,572,425,0,5,71,-21,-521,546,-147,541,-448,20
16:06.7,7,0,117,96,337,592,608,522,237,0,9,71,-21,-521,455,-285,446,-535,-74
16:06.8,7,40,231,210,430,596,608,522,237,0,9,160,-21,-435,455,-285,446,-721,11
16:06.8,7,40,231,210,430,596,355,382,75,0,9,160,-21,-435,270,-307,261,-906,-174
16:06.8,7,149,297,294,470,592,355,382,75,0,9,246,-3,-345,270,-307,261,-1028,-83
16:06.8,7,149,297,294,470,592,60,86,0,0,6,246,-3,-345,48,-86,42,-1253,-302
16:06.8,7,188,341,346,506,575,60,86,0,0,6,291,5,-283,48,-86,42,-1318,-240
16:06.9,7,188,341,346,506,575,0,14,0,0,4,291,5,-283,4,-14,0,-1364,-282
16:06.9,7,188,341,346,506,575,0,13,0,0,5,291,5,-283,4,-13,0,-1363,-284
16:06.9,7,175,396,369,537,550,0,13,0,0,5,313,-27,-236,4,-13,0,-1391,-237
16:06.9,7,123,426,369,562,504,0,13,0,0,5,306,-57,-198,4,-13,0,-1362,-198
16:06.9,7,123,426,369,562,504,0,0,0,0,3,306,-57,-198,0,0,-3,-1369,-201
16:07.0,7,129,443,400,572,461,0,0,0,0,3,324,-43,-137,0,0,-3,-1354,-140
16:07.0,7,129,443,400,572,461,0,0,0,0,4,324,-43,-137,0,0,-4,-1353,-141
16:07.0,7,155,459,436,578,413,0,0,0,0,4,350,-23,-63,0,0,-4,-1337,-67
16:07.0,7,155,459,436,578,413,0,0,0,0,4,350,-23,-63,0,0,-4,-1337,-67
16:07.1,7,155,459,436,578,413,6,0,0,0,2,350,-23,-63,2,0,0,-1337,-63
16:07.1,7,212,481,464,583,348,6,0,0,0,2,385,-17,37,2,0,0,-1312,37
16:07.1,7,263,508,505,587,248,6,0,0,0,2,425,-3,177,2,0,0,-1256,177
16:07.1,7,263,508,505,587,248,7,0,0,0,3,425,-3,177,2,0,0,-1255,176
16:07.2,7,318,525,540,586,162,7,0,0,0,3,461,15,299,2,0,0,-1203,298
16:07.2,7,318,525,540,586,162,7,0,0,0,2,461,15,299,2,0,0,-1204,299
16:07.2,7,365,543,576,578,71,7,0,0,0,2,494,33,423,2,0,0,-1139,424
16:07.2,7,365,543,576,578,71,7,0,0,0,2,494,33,423,2,0,0,-1139,424
16:07.3,7,423,551,611,556,13,7,0,0,0,2,528,60,515,2,0,0,-1093,515
16:07.3,7,500,558,637,505,6,7,0,0,0,2,565,79,559,2,0,0,-1071,559
16:07.3,7,500,558,637,505,6,0,7,0,0,0,565,79,559,2,-7,2,-1073,561
16:07.3,7,500,558,637,505,6,0,3,0,0,1,565,79,559,1,-3,0,-1074,559
16:07.4,7,547,557,661,388,0,0,3,0,0,1,588,104,588,1,-3,0,-974,588
16:07.4,7,547,557,661,388,0,0,0,1,0,331,588,104,588,0,1,-330,-645,257
16:07.4,7,573,526,658,199,0,0,0,1,0,331,585,132,585,0,1,-330,-453,255
16:07.4,7,573,526,658,199,0,0,0,73,119,504,585,132,585,24,73,-479,-137,106
16:07.4,7,579,383,582,31,0,0,0,73,119,504,514,199,514,24,73,-479,101,35
16:07.5,7,579,383,582,31,0,5,41,289,362,512,514,199,514,111,248,-400,440,114
16:07.5,7,477,255,527,6,0,5,41,289,362,512,419,272,419,111,248,-400,560,19
16:07.5,7,477,255,527,6,0,8,91,346,450,554,419,272,419,148,255,-405,726,14
16:07.5,7,187,121,361,0,0,8,91,346,450,554,223,240,223,148,255,-405,929,-182
16:07.5,7,187,121,361,0,0,48,163,381,488,571,223,240,223,197,218,-373,1033,-150
16:07.6,8,187,121,361,0,0,94,221,412,507,573,223,240,223,242,191,-330,1099,-107
16:07.6,8,19,68,32,0,0,94,221,412,507,573,39,-36,39,242,191,-330,1282,-291
16:07.6,8,2,7,0,0,0,94,221,412,507,573,3,-7,3,242,191,-330,1319,-327
16:07.6,8,2,7,0,0,0,125,249,416,508,576,3,-7,3,263,167,-312,1344,-309
16:07.7,8,2,7,0,0,0,129,254,424,512,577,3,-7,3,269,170,-308,1355,-305
16:07.7,8,9,3,0,0,0,129,254,424,512,577,4,-3,4,269,170,-308,1354,-304
16:07.7,8,14,5,0,0,0,129,254,424,512,577,6,-5,6,269,170,-308,1351,-301
16:07.7,8,14,5,0,0,0,122,255,436,520,571,6,-5,6,271,181,-300,1355,-293
16:07.8,8,14,5,0,0,0,122,196,457,541,560,6,-5,6,258,261,-301,1353,-295
16:07.8,8,42,6,0,0,0,122,196,457,541,560,16,-6,16,258,261,-301,1343,-285
16:07.8,8,59,9,0,1,0,122,196,457,541,560,22,-9,22,258,261,-301,1335,-279
16:07.8,8,59,9,0,1,0,127,209,482,556,544,22,-9,22,272,273,-271,1349,-248
16:07.8,8,59,9,0,1,0,153,287,499,566,519,22,-9,22,313,212,-206,1374,-183
16:07.9,8,65,12,0,1,0,153,287,499,566,519,25,-12,25,313,212,-206,1371,-180
16:07.9,8,49,12,0,0,0,153,287,499,566,519,20,-12,20,313,212,-206,1377,-185
16:07.9,8,49,12,0,0,0,203,369,529,573,460,20,-12,20,367,160,-93,1379,-72
16:07.9,8,49,12,0,0,0,298,422,567,578,340,20,-12,20,429,145,89,1326,109
16:07.9,8,27,13,0,0,0,298,422,567,578,340,13,-13,13,429,145,89,1333,102
16:08.0,8,8,15,0,6,0,298,422,567,578,340,7,-15,7,429,145,89,1333,96
16:08.0,8,8,15,0,6,0,392,478,591,577,145,7,-15,7,487,113,342,1195,349
16:08.0,8,0,13,0,6,21,392,478,591,577,145,4,-13,-16,487,113,342,1177,325
16:08.1,8,0,13,0,6,21,474,520,604,551,55,4,-13,-16,532,84,477,1107,461
16:08.1,8,0,13,0,19,438,474,520,604,551,55,4,-13,-433,532,84,477,677,44
16:08.1,8,0,13,0,19,438,531,551,613,443,35,4,-13,-433,565,62,530,581,96
16:08.1,8,0,50,0,100,573,531,551,613,443,35,16,-50,-556,565,62,530,353,-26
16:08.2,8,0,50,0,100,573,564,545,607,37,5,16,-50,-556,572,62,567,-75,10
16:08.2,8,0,50,0,100,573,535,484,498,0,9,16,-50,-556,505,14,496,-174,-59
16:08.2,8,0,125,68,329,591,535,484,498,0,9,64,-57,-526,505,14,496,-469,-30
16:08.2,8,17,231,172,427,598,535,484,498,0,9,140,-59,-458,505,14,496,-650,38
16:08.2,8,17,231,172,427,598,399,408,321,0,9,140,-59,-458,376,-87,367,-780,-91
16:08.3,8,17,231,172,427,598,151,184,110,0,12,140,-59,-458,148,-74,136,-1004,-321
16:08.3,8,63,328,234,486,581,151,184,110,0,12,208,-94,-372,148,-74,136,-1115,-236
16:08.3,8,109,377,369,504,566,151,184,110,0,12,285,-8,-281,148,-74,136,-1194,-144
16:08.3,8,109,377,369,504,566,0,16,2,0,6,285,-8,-281,6,-14,0,-1343,-281
16:08.4,8,109,377,369,504,566,0,0,0,0,5,285,-8,-281,0,0,-5,-1350,-286
16:08.4,8,167,394,453,503,539,0,0,0,0,5,338,59,-201,0,0,-5,-1375,-206
16:08.4,8,218,400,520,487,499,0,0,0,0,5,379,120,-119,0,0,-5,-1360,-124
16:08.4,8,218,400,520,487,499,0,0,0,0,4,379,120,-119,0,0,-4,-1361,-123
16:08.5,8,218,400,520,487,499,0,0,0,0,3,379,120,-119,0,0,-3,-1362,-122
16:08.5,8,253,399,552,474,481,0,0,0,0,3,401,153,-79,0,0,-3,-1353,-82
16:08.5,8,295,402,576,468,455,0,0,0,0,3,424,174,-30,0,0,-3,-1344,-33
16:08.5,8,295,402,576,468,455,0,0,0,0,3,424,174,-30,0,0,-3,-1344,-33
16:08.5,8,295,402,576,468,455,4,0,0,0,3,424,174,-30,1,0,-1,-1343,-32
16:08.6,9,343,419,601,465,404,4,0,0,0,3,454,182,50,1,0,-1,-1319,48
16:08.6,9,343,419,601,465,404,16,0,0,0,3,454,182,50,5,0,2,-1315,52
16:08.6,9,381,432,620,465,345,16,0,0,0,3,477,188,132,5,0,2,-1279,135
16:08.6,9,381,432,620,465,345,19,0,0,0,0,477,188,132,6,0,6,-1281,139
16:08.7,9,406,445,636,455,269,19,0,0,0,0,495,191,226,6,0,6,-1213,233
16:08.7,9,406,445,636,455,269,16,0,0,0,1,495,191,226,5,0,4,-1213,231
16:08.7,9,441,453,651,447,172,16,0,0,0,1,515,198,343,5,0,4,-1127,347
16:08.7,9,441,453,651,447,172,11,0,0,0,0,515,198,343,3,0,3,-1130,346
16:08.7,9,496,466,665,441,63,11,0,0,0,0,542,199,479,3,0,3,-1042,483
16:08.8,9,496,466,665,441,63,3,0,0,0,2,542,199,479,1,0,-1,-1043,478
16:08.8,9,545,481,684,401,18,3,0,0,0,2,570,203,552,1,0,-1,-986,551
16:08.8,9,545,481,684,401,18,0,0,6,0,349,570,203,552,2,6,-347,-638,205
16:08.8,9,582,475,695,229,0,0,0,6,0,349,584,220,584,2,6,-347,-462,237
16:08.9,9,582,475,695,229,0,0,0,76,119,505,584,220,584,25,76,-479,-163,104
16:08.9,9,602,404,682,48,0,0,0,76,119,505,562,278,562,25,76,-479,38,83
16:08.9,9,602,404,682,48,0,9,38,227,316,512,562,278,562,91,189,-420,308,142
16:08.9,9,605,206,597,0,0,9,38,227,316,512,469,391,469,91,189,-420,449,48
16:09.0,9,605,206,597,0,0,41,116,280,365,545,469,391,469,145,164,-399,586,70
16:09.0,9,567,59,554,0,0,41,116,280,365,545,393,495,393,145,164,-399,662,-6
16:09.0,9,567,59,554,0,0,49,160,323,430,567,393,495,393,177,163,-389,781,3
16:09.0,9,277,43,468,0,0,49,160,323,430,567,262,425,262,177,163,-389,911,-127
16:09.0,9,277,43,468,0,0,48,189,389,493,572,262,425,262,208,200,-363,1010,-100
16:09.0,9,52,26,136,0,0,48,189,389,493,572,71,110,71,208,200,-363,1202,-292
16:09.1,9,52,26,136,0,0,54,167,440,530,570,71,110,71,220,273,-349,1249,-278
16:09.1,9,0,2,4,0,0,54,167,440,530,570,2,2,2,220,273,-349,1318,-347
16:09.1,9,0,2,4,0,0,50,148,465,551,564,2,2,2,221,317,-343,1334,-341
16:09.1,9,4,0,4,0,0,50,148,465,551,564,2,4,2,221,317,-343,1333,-340
16:09.2,9,4,0,4,0,0,28,181,478,558,560,2,4,2,229,297,-331,1344,-328
16:09.2,9,3,1,6,0,0,28,181,478,558,560,3,5,3,229,297,-331,1343,-327
16:09.2,9,3,1,6,0,0,38,230,485,559,553,3,5,3,251,255,-302,1359,-298
16:09.3,9,4,5,0,0,0,38,230,485,559,553,3,-5,3,251,255,-302,1360,-299
16:09.3,9,4,5,0,0,0,61,296,496,562,532,3,-5,3,284,200,-247,1375,-244
16:09.3,9,13,7,0,0,0,61,296,496,562,532,6,-7,6,284,200,-247,1371,-241
16:09.3,9,13,7,0,0,0,119,348,515,569,496,6,-7,6,327,167,-168,1385,-162
16:09.4,9,20,9,0,0,0,119,348,515,569,496,9,-9,9,327,167,-168,1382,-159
16:09.4,9,28,10,0,0,0,119,348,515,569,496,12,-10,12,327,167,-168,1379,-156
16:09.4,9,28,10,0,0,0,194,398,552,575,434,12,-10,12,381,154,-52,1377,-40
16:09.4,9,28,10,0,0,0,299,438,577,578,347,12,-10,12,438,139,91,1350,103
16:09.4,9,28,10,0,0,0,385,491,593,579,177,12,-10,12,489,102,312,1233,325
16:09.5,10,28,10,0,0,0,460,533,606,568,72,12,-10,12,533,73,461,1160,473
16:09.5,10,22,13,5,0,0,460,533,606,568,72,13,-8,13,533,73,461,1159,474
16:09.5,10,8,15,7,0,0,460,533,606,568,72,10,-8,10,533,73,461,1163,471
16:09.5,10,0,13,4,2,0,460,533,606,568,72,5,-9,5,533,73,461,1165,466
16:09.5,10,0,13,4,2,0,523,566,616,529,39,5,-9,5,568,50,529,1128,535
16:09.6,10,0,8,0,4,234,523,566,616,529,39,2,-8,-231,568,50,529,895,298
16:09.6,10,0,8,0,4,234,571,584,620,363,21,2,-8,-231,591,36,570,735,339
16:09.6,10,0,19,0,18,492,571,584,620,363,21,6,-19,-485,591,36,570,459,85
16:09.6,10,0,19,0,18,492,595,566,595,0,6,6,-19,-485,585,29,579,75,93
16:09.7,10,0,59,20,182,559,595,566,595,0,6,26,-39,-532,585,29,579,-176,46
16:09.7,10,0,59,20,182,559,593,504,460,0,9,26,-39,-532,519,-44,510,-239,-22
16:09.7,10,15,166,164,317,585,593,504,460,0,9,115,-2,-470,519,-44,510,-489,40
16:09.7,10,15,166,164,317,585,525,450,273,0,10,115,-2,-470,416,-177,406,-591,-64
16:09.7,10,71,210,311,365,600,525,450,273,0,10,197,101,-402,416,-177,406,-736,3
16:09.8,10,71,210,311,365,600,217,211,87,0,11,197,101,-402,171,-124,160,-979,-242
16:09.8,10,139,280,407,408,595,217,211,87,0,11,275,127,-319,171,-124,160,-1095,-159
16:09.8,10,139,280,407,408,595,0,26,0,0,6,275,127,-319,8,-26,2,-1263,-317
16:09.8,10,212,321,481,423,583,0,26,0,0,6,338,160,-245,8,-26,2,-1329,-242
16:09.8,10,212,321,481,423,583,0,3,0,0,4,338,160,-245,1,-3,-3,-1339,-248
16:09.9,10,278,354,530,433,552,0,3,0,0,4,387,176,-164,1,-3,-3,-1367,-167
16:09.9,10,278,354,530,433,552,0,0,0,0,4,387,176,-164,0,0,-4,-1368,-168
16:09.9,10,317,382,557,432,492,0,0,0,0,4,418,175,-73,0,0,-4,-1338,-77
16:10.0,10,317,382,557,432,492,0,0,0,0,4,418,175,-73,0,0,-4,-1338,-77
16:10.0,10,345,396,577,430,444,0,0,0,0,4,439,181,-4,0,0,-4,-1309,-8
16:10.0,10,345,396,577,430,444,0,0,0,0,5,439,181,-4,0,0,-5,-1308,-9
16:10.0,10,362,410,601,440,397,0,0,0,0,5,457,191,60,0,0,-5,-1289,55
16:10.1,10,362,410,601,440,397,3,0,0,0,5,457,191,60,1,0,-4,-1288,56
16:10.1,10,392,426,617,453,324,3,0,0,0,5,478,191,154,1,0,-4,-1249,150
16:10.1,10,392,426,617,453,324,15,0,0,0,4,478,191,154,5,0,1,-1246,155
16:10.1,10,433,442,635,460,222,15,0,0,0,4,503,193,281,5,0,1,-1176,282
16:10.1,10,433,442,635,460,222,29,0,0,0,3,503,193,281,9,0,6,-1172,288
16:10.2,10,491,462,652,461,93,29,0,0,0,3,535,190,442,9,0,6,-1076,448
16:10.2,10,491,462,652,461,93,40,0,0,0,2,535,190,442,13,0,11,-1073,453
16:10.2,10,543,482,674,442,16,40,0,0,0,2,566,192,550,13,0,11,-1009,561
16:10.2,10,543,482,674,442,16,22,0,0,0,0,566,192,550,7,0,7,-1017,557
16:10.2,10,576,492,693,376,7,22,0,0,0,0,587,201,580,7,0,7,-962,587
16:10.3,10,576,492,693,376,7,4,0,0,0,7,587,201,580,1,0,-5,-961,574
16:10.3,10,607,484,704,201,0,4,0,0,0,7,598,220,598,1,0,-5,-791,592
16:10.3,10,607,484,704,201,0,6,0,5,0,407,598,220,598,3,5,-403,-388,195
16:10.3,10,621,410,702,45,0,6,0,5,0,407,577,292,577,3,5,-403,-211,174
16:10.4,10,621,410,702,45,0,2,0,78,173,503,577,292,577,26,78,-476,80,101
16:10.4,10,624,222,630,0,0,2,0,78,173,503,492,408,492,26,78,-476,210,15
16:10.4,10,624,222,630,0,0,19,36,275,359,521,492,408,492,110,239,-411,498,81
16:10.4,10,584,81,586,0,0,19,36,275,359,521,417,505,417,110,239,-411,573,6
16:10.4,10,584,81,586,0,0,43,94,317,427,545,417,505,417,151,223,-393,706,23
16:10.5,10,279,47,487,0,0,43,94,317,427,545,271,440,271,151,223,-393,852,-122
16:10.5,10,279,47,487,0,0,61,166,352,472,556,271,440,271,193,186,-363,950,-92
16:10.5,10,279,47,487,0,0,78,220,377,486,565,271,440,271,225,157,-340,1005,-69
16:10.6,11,28,39,103,0,0,78,220,377,486,565,56,64,56,225,157,-340,1219,-283
16:10.6,11,0,0,0,0,0,78,220,377,486,565,0,0,0,225,157,-340,1276,-340
16:10.6,11,0,0,0,0,0,104,302,371,479,572,0,0,0,259,69,-313,1310,-313
16:10.6,11,0,0,0,0,0,146,351,375,475,572,0,0,0,290,24,-281,1337,-281
16:10.6,11,12,0,0,0,0,146,351,375,475,572,4,0,4,290,24,-281,1333,-277
16:10.7,11,6,1,4,0,0,146,351,375,475,572,3,3,3,290,24,-281,1334,-277
16:10.7,11,6,1,4,0,0,179,383,406,486,561,3,3,3,322,23,-238,1366,-234
16:10.7,11,6,1,4,0,0,214,410,431,495,537,3,3,3,351,21,-185,1380,-181
16:10.7,11,13,4,0,0,0,214,410,431,495,537,5,-4,5,351,21,-185,1378,-179
16:10.8,11,23,7,0,0,0,214,410,431,495,537,10,-7,10,351,21,-185,1373,-175
16:10.8,11,23,7,0,0,0,264,445,445,502,509,10,-7,10,384,0,-124,1385,-114
16:10.8,11,23,7,0,0,0,321,488,463,507,469,10,-7,10,424,-25,-45,1390,-35
16:10.8,11,30,9,0,0,0,321,488,463,507,469,13,-9,13,424,-25,-45,1387,-32
16:10.9,11,22,12,0,0,0,321,488,463,507,469,11,-12,11,424,-25,-45,1388,-33
16:10.9,11,22,12,0,0,0,388,525,476,513,404,11,-12,11,463,-49,59,1368,70
16:10.9,11,22,12,0,0,0,455,559,504,504,252,11,-12,11,506,-55,254,1250,265
16:10.9,11,11,13,3,3,0,455,559,504,504,252,9,-10,9,506,-55,254,1250,263
16:10.9,11,4,18,8,5,0,455,559,504,504,252,10,-10,10,506,-55,254,1247,264
16:10.9,11,4,18,8,5,0,525,592,537,490,98,10,-10,10,551,-55,453,1124,463
16:11.0,11,4,18,8,5,0,577,614,559,428,43,10,-10,10,583,-55,540,1039,550
16:11.0,11,0,12,0,5,140,577,614,559,428,43,4,-12,-136,583,-55,540,905,404
16:11.0,11,0,15,2,14,472,577,614,559,428,43,5,-13,-466,583,-55,540,562,74
16:11.1,11,0,15,2,14,472,607,625,566,105,28,5,-13,-466,599,-59,571,240,105
16:11.1,11,0,15,2,14,472,617,584,486,0,6,5,-13,-466,562,-98,556,76,90
16:11.1,11,0,50,20,155,559,617,584,486,0,6,23,-30,-535,562,-98,556,-169,20
16:11.1,11,0,50,20,155,559,600,528,293,0,8,23,-30,-535,473,-235,465,-255,-70
16:11.2,11,41,118,252,252,579,600,528,293,0,8,137,134,-442,473,-235,465,-486,23
16:11.2,11,41,118,252,252,579,422,428,108,0,15,137,134,-442,319,-320,304,-633,-137
16:11.2,11,98,148,385,286,599,422,428,108,0,15,210,237,-388,319,-320,304,-761,-84
16:11.2,11,98,148,385,286,599,129,134,0,0,15,210,237,-388,87,-134,72,-992,-316
16:11.2,11,160,192,458,352,603,129,134,0,0,15,270,266,-333,87,-134,72,-1122,-260
16:11.2,11,160,192,458,352,603,0,0,0,0,8,270,266,-333,0,0,-8,-1217,-341
16:11.3,11,192,226,519,383,604,0,0,0,0,8,312,293,-291,0,0,-8,-1291,-299
16:11.3,11,192,226,519,383,604,0,0,0,0,9,312,293,-291,0,0,-9,-1290,-300
16:11.3,11,232,259,556,396,590,0,0,0,0,9,349,297,-241,0,0,-9,-1326,-250
16:11.4,11,232,259,556,396,590,0,0,0,0,6,349,297,-241,0,0,-6,-1329,-247
16:11.4,11,264,280,577,400,573,0,0,0,0,6,373,297,-199,0,0,-6,-1340,-205
16:11.4,11,264,280,577,400,573,0,0,0,0,5,373,297,-199,0,0,-5,-1341,-204
16:11.4,11,269,287,594,396,558,0,0,0,0,5,383,307,-174,0,0,-5,-1332,-179
16:11.4,11,285,299,609,401,542,0,0,0,0,5,397,310,-144,0,0,-5,-1335,-149
16:11.5,11,285,299,609,401,542,0,0,0,0,5,397,310,-144,0,0,-5,-1335,-149
16:11.5,11,285,299,609,401,542,2,0,0,0,4,397,310,-144,0,0,-3,-1336,-147
16:11.5,11,330,339,626,420,506,2,0,0,0,4,431,287,-74,0,0,-3,-1353,-77
16:11.5,11,408,375,643,433,426,2,0,0,0,4,475,268,49,0,0,-3,-1329,46
16:11.6,12,408,375,643,433,426,6,0,0,0,5,475,268,49,2,0,-3,-1327,46
16:11.6,12,408,375,643,433,426,6,0,0,0,2,475,268,49,2,0,0,-1330,49
16:11.6,12,494,409,659,439,245,6,0,0,0,2,520,250,275,2,0,0,-1200,275
16:11.6,12,555,431,678,432,68,6,0,0,0,2,554,247,486,2,0,0,-1050,486
16:11.6,12,555,431,678,432,68,6,0,0,0,3,554,247,486,2,0,-1,-1049,485
16:11.7,12,555,431,678,432,68,0,0,0,0,2,554,247,486,0,0,-2,-1052,484
16:11.7,12,587,448,693,373,16,0,0,0,0,2,576,245,560,0,0,-2,-963,558
16:11.7,12,615,447,703,210,0,0,0,0,0,2,588,256,588,0,0,-2,-796,586
16:11.7,12,615,447,703,210,0,0,0,0,0,273,588,256,588,0,0,-273,-525,315
16:11.8,12,615,447,703,210,0,0,0,45,0,524,588,256,588,15,45,-509,-259,79
16:11.8,12,628,392,696,52,0,0,0,45,0,524,572,304,572,15,45,-509,-85,63
16:11.8,12,628,392,696,52,0,1,9,212,338,542,572,304,572,74,203,-468,330,104
16:11.8,12,631,205,618,0,0,1,9,212,338,542,484,413,484,74,203,-468,469,16
16:11.8,12,631,205,618,0,0,62,91,298,396,559,484,413,484,150,207,-408,620,76
16:11.9,12,587,41,586,0,0,62,91,298,396,559,404,545,404,150,207,-408,700,-4
16:11.9,12,587,41,586,0,0,112,174,300,413,582,404,545,404,195,126,-386,785,18
16:11.9,12,272,36,469,0,0,112,174,300,413,582,259,433,259,195,126,-386,931,-127
16:11.9,12,272,36,469,0,0,137,210,314,438,592,259,433,259,220,104,-371,991,-112
16:12.0,12,35,14,104,0,0,137,210,314,438,592,51,90,51,220,104,-371,1199,-320
16:12.0,12,35,14,104,0,0,144,226,331,461,599,51,90,51,233,105,-365,1242,-314
16:12.0,12,2,0,14,0,0,144,226,331,461,599,5,14,5,233,105,-365,1288,-360
16:12.0,12,2,0,14,0,0,139,237,333,468,602,5,14,5,236,96,-365,1301,-360
16:12.1,12,12,0,3,0,0,139,237,333,468,602,5,3,5,236,96,-365,1301,-360
16:12.1,12,12,0,3,0,0,78,198,320,467,605,5,3,5,198,122,-406,1265,-401
16:12.1,12,19,0,0,0,0,78,198,320,467,605,6,0,6,198,122,-406,1264,-400
16:12.1,12,19,0,0,0,0,33,179,309,470,606,6,0,6,173,130,-432,1243,-426
16:12.1,12,40,2,0,0,0,33,179,309,470,606,14,-2,14,173,130,-432,1235,-418
16:12.2,12,40,2,0,0,0,26,156,345,489,604,14,-2,14,175,189,-428,1254,-414
16:12.2,12,54,3,0,0,0,26,156,345,489,604,19,-3,19,175,189,-428,1249,-409
16:12.2,12,54,3,0,0,0,32,173,393,514,599,19,-3,19,199,220,-399,1293,-380
16:12.2,12,63,7,0,0,0,32,173,393,514,599,23,-7,23,199,220,-399,1289,-376
16:12.3,12,63,7,0,0,0,67,238,439,533,584,23,-7,23,248,201,-336,1341,-312
16:12.3,12,63,7,0,0,0,184,354,468,545,539,23,-7,23,335,114,-203,1396,-180
16:12.4,12,54,7,0,0,0,184,354,468,545,539,20,-7,20,335,114,-203,1399,-183
16:12.4,12,35,10,0,0,0,184,354,468,545,539,15,-10,15,335,114,-203,1404,-188
16:12.4,12,35,10,0,0,0,350,439,493,550,434,15,-10,15,427,54,-6,1396,8
16:12.4,12,28,8,2,0,0,350,439,493,550,434,12,-6,12,427,54,-6,1398,6
16:12.4,12,28,8,2,0,0,467,522,541,547,200,12,-6,12,510,19,310,1244,322
16:12.4,12,7,5,3,0,0,467,522,541,547,200,5,-2,5,510,19,310,1252,315
16:12.4,12,7,5,3,0,0,545,570,573,503,86,5,-2,5,562,3,476,1146,481
16:12.5,12,0,1,0,7,197,545,570,573,503,86,0,-1,-196,562,3,476,947,280
16:12.5,12,0,1,0,7,197,592,591,581,289,35,0,-1,-196,588,-10,553,707,356
16:12.5,12,0,12,0,18,501,592,591,581,289,35,4,-12,-497,588,-10,553,389,56
16:12.5,12,0,12,0,18,501,615,570,521,0,4,4,-12,-497,568,-49,564,49,67
16:12.6,13,0,45,4,136,586,615,570,521,0,4,16,-41,-569,568,-49,564,-165,-5
16:12.6,13,0,45,4,136,586,609,499,325,0,5,16,-41,-569,477,-174,472,-255,-97
16:12.6,13,0,45,4,136,586,550,446,111,0,8,16,-41,-569,369,-335,361,-361,-208
16:12.6,13,20,94,92,275,603,550,446,111,0,8,68,-2,-534,369,-335,361,-569,-173
16:12.7,13,86,136,267,315,614,550,446,111,0,8,163,131,-451,369,-335,361,-715,-90
16:12.7,13,86,136,267,315,614,235,243,16,0,12,163,131,-451,164,-227,152,-915,-298
16:12.7,13,158,198,393,380,613,235,243,16,0,12,249,195,-363,164,-227,152,-1065,-210
16:12.7,13,158,198,393,380,613,17,73,0,0,13,249,195,-363,30,-73,17,-1199,-346
16:12.7,13,229,248,451,420,610,17,73,0,0,13,309,203,-300,30,-73,17,-1296,-283
16:12.8,13,229,248,451,420,610,0,25,0,0,9,309,203,-300,8,-25,0,-1322,-301
16:12.8,13,282,284,511,428,594,0,25,0,0,9,359,227,-235,8,-25,0,-1363,-235
16:12.8,13,282,284,511,428,594,0,18,0,0,5,359,227,-235,6,-18,1,-1370,-234
16:12.8,13,312,310,545,436,577,0,18,0,0,5,389,235,-188,6,-18,1,-1391,-187
16:12.9,13,312,310,545,436,577,0,3,0,0,9,389,235,-188,1,-3,-8,-1392,-196
16:12.9,13,307,329,571,443,562,0,3,0,0,9,402,242,-159,1,-3,-8,-1397,-167
16:12.9,13,307,329,571,443,562,0,0,0,0,8,402,242,-159,0,0,-8,-1399,-167
16:12.9,13,295,343,588,451,544,0,0,0,0,8,408,245,-135,0,0,-8,-1395,-143
16:13.0,13,295,343,588,451,544,0,0,0,0,8,408,245,-135,0,0,-8,-1395,-143
16:13.0,13,317,378,603,466,514,0,0,0,0,8,432,225,-81,0,0,-8,-1404,-89
16:13.0,13,317,378,603,466,514,0,0,0,0,7,432,225,-81,0,0,-7,-1405,-88
16:13.0,13,356,402,622,476,447,0,0,0,0,7,460,220,13,0,0,-7,-1376,6
16:13.0,13,356,402,622,476,447,5,0,0,0,9,460,220,13,1,0,-7,-1372,5
16:13.1,13,394,424,637,481,341,5,0,0,0,9,485,213,144,1,0,-7,-1296,136
16:13.1,13,394,424,637,481,341,6,0,0,0,5,485,213,144,2,0,-3,-1300,141
16:13.1,13,448,451,655,479,199,6,0,0,0,5,518,204,319,2,0,-3,-1189,316
16:13.1,13,448,451,655,479,199,6,0,0,0,6,518,204,319,2,0,-4,-1188,315
16:13.2,13,514,475,671,470,63,6,0,0,0,6,553,196,490,2,0,-4,-1078,486
16:13.2,13,514,475,671,470,63,0,0,0,0,4,553,196,490,0,0,-4,-1082,486
16:13.2,13,557,494,693,437,16,0,0,0,0,4,581,199,565,0,0,-4,-1030,561
16:13.2,13,557,494,693,437,16,0,0,0,0,54,581,199,565,0,0,-54,-980,511
16:13.3,13,588,510,703,313,0,0,0,0,0,54,600,193,600,0,0,-54,-859,546
16:13.3,13,588,510,703,313,0,0,0,23,0,376,600,193,600,7,23,-368,-529,232
16:13.3,13,606,500,688,149,0,0,0,23,0,376,598,188,598,7,23,-368,-363,229
16:13.3,13,606,500,688,149,0,0,9,168,263,455,598,188,598,59,159,-396,30,202
16:13.3,13,610,409,603,33,0,0,9,168,263,455,540,194,540,59,159,-396,203,144
16:13.4,13,610,409,603,33,0,43,73,282,338,486,540,194,540,132,209,-353,383,187
16:13.4,13,538,307,565,5,0,43,73,282,338,486,470,258,470,132,209,-353,481,116
16:13.4,13,538,307,565,5,0,70,132,320,419,533,470,258,470,174,188,-359,651,111
16:13.4,13,325,154,488,0,0,70,132,320,419,533,322,334,322,174,188,-359,803,-36
16:13.5,14,325,154,488,0,0,102,186,360,473,563,322,334,322,216,174,-347,929,-24
16:13.5,14,325,154,488,0,0,112,241,380,488,576,322,334,322,244,139,-331,986,-9
16:13.5,14,118,87,224,0,0,112,241,380,488,576,143,137,143,244,139,-331,1165,-188
16:13.5,14,8,12,0,0,0,112,241,380,488,576,6,-12,6,244,139,-331,1301,-325
16:13.5,14,8,12,0,0,0,122,290,378,490,583,6,-12,6,263,88,-319,1329,-313
16:13.6,14,0,0,0,0,0,122,290,378,490,583,0,0,0,263,88,-319,1336,-319
16:13.6,14,0,0,0,0,0,151,339,382,490,580,0,0,0,290,43,-289,1360,-289
16:13.6,14,2,0,0,0,0,151,339,382,490,580,0,0,0,290,43,-289,1360,-288
16:13.6,14,2,0,0,0,0,193,368,400,492,565,0,0,0,320,32,-244,1376,-244
16:13.7,14,7,1,0,0,0,193,368,400,492,565,2,-1,2,320,32,-244,1374,-242
16:13.7,14,7,1,0,0,0,221,393,423,494,546,2,-1,2,345,30,-200,1383,-197
16:13.7,14,7,1,0,0,0,261,426,441,499,517,2,-1,2,376,15,-141,1389,-138
16:13.7,14,13,2,0,0,0,261,426,441,499,517,5,-2,5,376,15,-141,1387,-136
16:13.8,14,11,4,0,0,0,261,426,441,499,517,5,-4,5,376,15,-141,1387,-136
16:13.8,14,11,4,0,0,0,321,477,459,506,473,5,-4,5,419,-18,-54,1393,-49
16:13.8,14,11,4,0,0,0,384,513,483,521,406,5,-4,5,460,-30,54,1382,59
16:13.8,14,8,8,0,0,0,384,513,483,521,406,5,-8,5,460,-30,54,1381,59
16:13.9,14,2,15,0,0,0,384,513,483,521,406,5,-15,5,460,-30,54,1381,59
16:13.9,14,2,15,0,0,0,449,551,514,525,240,5,-15,5,504,-37,264,1264,270
16:13.9,14,2,15,0,0,0,517,582,558,512,104,5,-15,5,552,-24,448,1162,454
16:13.9,14,0,16,5,0,0,517,582,558,512,104,7,-11,7,552,-24,448,1161,455
16:13.9,14,0,6,0,3,177,517,582,558,512,104,2,-6,-175,552,-24,448,986,273
16:14.0,14,0,6,0,3,177,565,601,579,440,53,2,-6,-175,581,-22,528,892,353
16:14.0,14,0,6,0,3,177,595,599,580,79,16,2,-6,-175,591,-19,575,504,400
16:14.0,14,0,13,0,18,507,595,599,580,79,16,4,-13,-502,591,-19,575,157,72
16:14.0,14,0,69,4,230,588,595,599,580,79,16,24,-65,-563,591,-19,575,-156,11
16:14.0,14,0,69,4,230,588,593,522,499,0,4,24,-65,-563,538,-23,534,-300,-29
16:14.1,14,0,69,4,230,588,508,449,298,0,6,24,-65,-563,418,-151,412,-418,-151
16:14.1,14,25,195,107,363,599,508,449,298,0,6,109,-88,-490,418,-151,412,-646,-77
16:14.1,14,96,263,218,421,607,508,449,298,0,6,192,-45,-414,418,-151,412,-796,-2
16:14.1,14,96,263,218,421,607,222,305,95,0,6,192,-45,-414,207,-210,201,-1007,-213
16:14.2,14,158,325,313,454,599,222,305,95,0,6,265,-12,-333,207,-210,201,-1105,-132
16:14.2,14,158,325,313,454,599,14,61,0,0,10,265,-12,-333,25,-61,15,-1283,-318
16:14.2,14,182,365,350,481,586,14,61,0,0,10,299,-15,-287,25,-61,15,-1331,-272
16:14.2,14,182,365,350,481,586,0,0,0,0,6,299,-15,-287,0,0,-6,-1360,-293
16:14.3,14,180,405,375,500,567,0,0,0,0,6,320,-30,-247,0,0,-6,-1381,-253
16:14.3,14,172,425,404,508,540,0,0,0,0,6,333,-21,-206,0,0,-6,-1375,-212
16:14.3,14,172,425,404,508,540,0,0,0,0,5,333,-21,-206,0,0,-5,-1376,-211
16:14.3,14,172,425,404,508,540,0,0,0,0,5,333,-21,-206,0,0,-5,-1376,-211
16:14.4,14,159,437,452,510,527,0,0,0,0,5,349,15,-177,0,0,-5,-1381,-182
16:14.4,14,159,437,452,510,527,0,0,0,0,6,349,15,-177,0,0,-6,-1380,-183
16:14.4,14,159,437,452,510,527,0,0,0,0,6,349,15,-177,0,0,-6,-1380,-183
16:14.4,14,146,442,493,509,525,0,0,0,0,6,360,51,-164,0,0,-6,-1388,-170
16:14.4,14,169,455,535,509,510,0,0,0,0,6,386,80,-123,0,0,-6,-1399,-129
16:14.5,14,169,455,535,509,510,0,0,0,0,5,386,80,-123,0,0,-5,-1400,-128
16:14.5,14,169,455,535,509,510,0,0,0,0,5,386,80,-123,0,0,-5,-1400,-128
16:14.5,14,224,473,565,508,457,0,0,0,0,5,420,92,-36,0,0,-5,-1380,-41
16:14.5,14,280,483,592,509,367,0,0,0,0,5,451,109,84,0,0,-5,-1322,79
16:14.6,15,280,483,592,509,367,0,0,0,0,5,451,109,84,0,0,-5,-1322,79
16:14.6,15,280,483,592,509,367,0,0,0,0,4,451,109,84,0,0,-4,-1323,80
16:14.6,15,342,501,614,510,247,0,0,0,0,4,485,113,238,0,0,-4,-1238,234
16:14.6,15,416,522,631,511,100,0,0,0,0,4,523,109,423,0,0,-4,-1130,419
16:14.6,15,416,522,631,511,100,0,0,0,0,4,523,109,423,0,0,-4,-1130,419
16:14.7,15,416,522,631,511,100,0,0,0,0,0,523,109,423,0,0,0,-1134,423
16:14.7,15,476,545,652,487,20,0,0,0,0,0,557,107,537,0,0,0,-1064,537
16:14.7,15,529,559,669,405,0,0,0,0,0,0,585,110,585,0,0,0,-990,585
16:14.7,15,529,559,669,405,0,0,0,2,0,318,585,110,585,0,2,-317,-672,268
16:14.8,15,529,559,669,405,0,0,0,51,114,481,585,110,585,17,51,-464,-378,121
16:14.8,15,559,546,672,208,0,0,0,51,114,481,592,126,592,17,51,-464,-188,128
16:14.8,15,573,437,606,45,0,0,0,51,114,481,538,169,538,17,51,-464,28,74
16:14.8,15,573,437,606,45,0,8,26,214,308,504,538,169,538,82,188,-421,311,117
16:14.8,15,573,437,606,45,0,53,79,267,360,539,538,169,538,133,188,-406,448,132
16:14.9,15,508,311,580,4,0,53,79,267,360,539,466,269,466,133,188,-406,561,60
16:14.9,15,289,159,506,0,0,53,79,267,360,539,318,347,318,133,188,-406,714,-88
16:14.9,15,289,159,506,0,0,100,145,317,446,573,318,347,318,187,172,-385,888,-67
16:15.0,15,289,159,506,0,0,145,180,370,495,588,318,347,318,231,190,-356,996,-38
16:15.0,15,104,97,255,0,0,145,180,370,495,588,152,158,152,231,190,-356,1162,-204
16:15.0,15,104,97,255,0,0,178,226,389,505,593,152,158,152,264,163,-328,1210,-176
16:15.0,15,19,30,0,0,0,178,226,389,505,593,16,-30,16,264,163,-328,1346,-312
16:15.0,15,19,30,0,0,0,234,279,402,508,588,16,-30,16,305,123,-283,1384,-266
16:15.1,15,8,2,0,0,0,234,279,402,508,588,3,-2,3,305,123,-283,1397,-279
16:15.1,15,8,2,0,0,0,266,333,411,509,579,3,-2,3,336,78,-242,1421,-239
16:15.1,15,16,4,0,0,0,266,333,411,509,579,6,-4,6,336,78,-242,1418,-235
16:15.1,15,16,4,0,0,0,316,376,419,507,569,6,-4,6,370,43,-198,1439,-192
16:15.2,15,21,5,0,0,0,316,376,419,507,569,8,-5,8,370,43,-198,1437,-190
16:15.2,15,21,5,0,0,0,385,409,433,510,553,8,-5,8,409,24,-144,1463,-135
16:15.2,15,45,7,0,0,0,385,409,433,510,553,17,-7,17,409,24,-144,1454,-126
16:15.2,15,45,7,0,0,0,439,435,452,522,524,17,-7,17,442,17,-82,1470,-64
16:15.2,15,62,12,0,4,0,439,435,452,522,524,24,-12,24,442,17,-82,1459,-57
16:15.3,15,62,12,0,4,0,468,458,468,527,489,24,-12,24,464,10,-24,1452,0
16:15.3,15,62,12,0,6,0,468,458,468,527,489,24,-12,24,464,10,-24,1450,0
16:15.3,15,62,12,0,6,0,500,481,476,530,456,24,-12,24,485,-5,29,1441,54
16:15.3,15,38,13,0,9,0,500,481,476,530,456,17,-13,17,485,-5,29,1445,46
16:15.4,15,38,13,0,9,0,526,497,484,526,385,17,-13,17,502,-13,117,1387,134
16:15.4,15,25,14,0,12,24,526,497,484,526,385,13,-14,-11,502,-13,117,1364,106
16:15.4,15,25,14,0,12,24,540,510,494,515,268,13,-14,-11,514,-16,246,1248,235
16:15.4,15,14,12,2,27,266,540,510,494,515,268,9,-10,-256,514,-16,246,995,-10
16:15.5,15,14,12,2,27,266,551,492,500,481,130,9,-10,-256,514,8,384,823,127
16:15.5,15,110,61,202,217,383,551,492,500,481,130,124,141,-258,514,8,384,401,125
16:15.5,15,110,61,202,217,383,551,437,496,378,49,124,141,-258,494,59,445,197,187
16:15.5,15,258,164,294,296,396,551,437,496,378,49,238,130,-157,494,59,445,-8,288
16:15.6,16,302,201,282,357,425,551,437,496,378,49,261,81,-163,494,59,445,-122,282
16:15.6,16,302,201,282,357,425,539,395,491,204,21,261,81,-163,475,96,454,-343,290
16:15.6,16,302,201,282,357,425,527,377,475,12,4,261,81,-163,459,98,455,-568,292
16:15.6,16,283,221,217,389,463,527,377,475,12,4,240,-4,-222,459,98,455,-616,233
16:15.6,16,283,221,217,389,463,509,324,418,0,6,240,-4,-222,417,94,411,-669,188
16:15.7,16,219,191,91,392,507,509,324,418,0,6,167,-100,-340,417,94,411,-643,71
16:15.7,16,219,191,91,392,507,483,300,328,0,4,167,-100,-340,370,28,366,-691,26
16:15.7,16,161,142,15,381,547,483,300,328,0,4,106,-127,-441,370,28,366,-659,-74
16:15.7,16,129,98,4,372,580,483,300,328,0,4,77,-94,-503,370,28,366,-654,-136
16:15.8,16,129,98,4,372,580,458,288,252,0,6,77,-94,-503,332,-36,326,-690,-176
16:15.8,16,129,98,4,372,580,397,281,150,0,10,77,-94,-503,276,-131,266,-743,-237
16:15.8,16,117,71,0,368,602,397,281,150,0,10,62,-71,-539,276,-131,266,-746,-273
16:15.8,16,117,71,0,368,602,218,202,50,0,10,62,-71,-539,156,-152,146,-866,-392
16:15.8,16,118,66,0,380,615,218,202,50,0,10,61,-66,-553,156,-152,146,-889,-407
16:15.9,16,118,66,0,380,615,60,68,17,0,9,61,-66,-553,48,-51,39,-998,-514
16:15.9,16,118,63,0,394,622,60,68,17,0,9,60,-63,-561,48,-51,39,-1018,-522
16:15.9,16,118,63,0,394,622,0,30,9,0,7,60,-63,-561,13,-21,6,-1056,-555
16:16.0,16,118,63,0,394,622,0,0,6,0,5,60,-63,-561,2,6,-3,-1069,-564
16:16.0,16,120,70,0,407,625,0,0,6,0,5,63,-70,-561,2,6,-3,-1088,-564
16:16.0,16,133,87,0,424,625,0,0,6,0,5,73,-87,-551,2,6,-3,-1115,-554
16:16.0,16,133,87,0,424,625,0,0,5,0,5,73,-87,-551,1,5,-3,-1115,-555
16:16.0,16,148,114,0,445,624,0,0,5,0,5,87,-114,-536,1,5,-3,-1149,-540
16:16.1,16,148,114,0,445,624,0,0,5,0,5,87,-114,-536,1,5,-3,-1149,-540
16:16.1,16,160,133,0,457,624,0,0,5,0,5,97,-133,-526,1,5,-3,-1171,-529
16:16.1,16,160,133,0,457,624,0,0,1,0,6,97,-133,-526,0,1,-5,-1172,-532
16:16.1,16,162,155,2,462,623,0,0,1,0,6,106,-153,-516,0,1,-5,-1185,-522
16:16.1,16,162,155,2,462,623,0,0,0,0,6,106,-153,-516,0,0,-6,-1185,-522
16:16.2,16,164,168,13,463,621,0,0,0,0,6,115,-155,-506,0,0,-6,-1193,-512
16:16.2,16,164,168,13,463,621,0,0,1,0,3,115,-155,-506,0,1,-2,-1195,-508
16:16.2,16,143,177,11,460,618,0,0,1,0,3,110,-166,-507,0,1,-2,-1185,-510
16:16.2,16,143,177,11,460,618,2,24,46,0,4,110,-166,-507,24,22,20,-1160,-487
16:16.3,16,143,177,11,460,618,7,152,139,85,96,110,-166,-507,99,-13,3,-908,-504
16:16.3,16,120,185,1,447,611,7,152,139,85,96,102,-184,-509,99,-13,3,-879,-505
16:16.3,16,88,162,0,410,581,7,152,139,85,96,83,-162,-497,99,-13,3,-794,-494
16:16.3,16,48,147,0,353,501,7,152,139,85,96,65,-147,-436,99,-13,3,-638,-432
16:16.4,16,48,147,0,353,501,37,234,249,255,239,65,-147,-436,173,15,-65,-251,-501
16:16.4,16,48,147,0,353,501,90,304,369,370,320,65,-147,-436,254,65,-65,25,-501
16:16.4,16,32,139,0,280,365,90,304,369,370,320,57,-139,-308,254,65,-65,242,-373
16:16.4,16,32,139,0,280,365,186,355,441,491,363,57,-139,-308,327,86,-35,479,-343
16:16.4,16,32,128,0,193,61,186,355,441,491,363,53,-128,-7,327,86,-35,873,-43
16:16.5,16,32,128,0,193,61,249,382,471,530,423,53,-128,-7,367,89,-55,1012,-63
16:16.5,16,36,66,0,49,0,249,382,471,530,423,34,-66,34,367,89,-55,1237,-21
16:16.5,16,36,66,0,49,0,275,389,484,546,457,34,-66,34,382,95,-74,1302,-40
16:16.5,16,28,18,0,7,0,275,389,484,546,457,15,-18,15,382,95,-74,1363,-59
16:16.6,17,28,18,0,7,0,274,385,490,549,467,15,-18,15,383,105,-84,1376,-68
16:16.6,17,20,12,0,4,0,274,385,490,549,467,10,-12,10,383,105,-84,1384,-73
16:16.6,17,7,8,0,0,0,274,385,490,549,467,5,-8,5,383,105,-84,1394,-79
16:16.6,17,7,8,0,0,0,283,387,498,554,450,5,-8,5,389,111,-60,1388,-55
16:16.6,17,7,8,0,0,0,341,404,521,563,373,5,-8,5,422,117,49,1353,54
16:16.7,17,0,9,1,0,0,341,404,521,563,373,3,-8,3,422,117,49,1354,52
16:16.7,17,0,9,1,0,0,396,437,545,569,281,3,-8,3,459,108,178,1306,181
16:16.7,17,0,14,9,5,7,396,437,545,569,281,7,-5,0,459,108,178,1289,179
16:16.7,17,0,14,9,5,7,449,470,562,569,159,7,-5,0,493,92,334,1202,335
16:16.8,17,0,14,28,10,121,449,470,562,569,159,14,14,-107,493,92,334,1076,227
16:16.8,17,0,14,28,10,121,491,498,571,561,79,14,14,-107,520,73,441,1015,334
16:16.8,17,30,16,114,73,320,491,498,571,561,79,53,98,-266,520,73,441,713,174
16:16.8,17,30,16,114,73,320,517,516,569,491,43,53,98,-266,534,53,491,621,224
16:16.9,17,167,48,311,155,401,517,516,569,491,43,175,263,-225,534,53,491,336,265
16:16.9,17,167,48,311,155,401,531,509,542,122,6,175,263,-225,527,33,521,-76,295
16:16.9,17,277,87,420,210,442,531,509,542,122,6,261,333,-180,527,33,521,-257,340
16:16.9,17,277,87,420,210,442,516,441,397,0,7,261,333,-180,451,-44,444,-454,263
16:16.9,17,331,133,494,276,477,516,441,397,0,7,319,361,-157,451,-44,444,-614,286
16:17.0,17,331,133,494,276,477,449,390,111,0,7,319,361,-157,316,-279,309,-748,152
16:17.0,17,331,133,494,276,477,213,267,0,0,7,319,361,-157,160,-267,153,-905,-4
16:17.0,17,372,183,532,362,505,213,267,0,0,7,362,349,-142,160,-267,153,-1062,10
16:17.0,17,398,228,552,406,522,213,267,0,0,7,392,324,-129,160,-267,153,-1153,23
16:17.0,17,398,228,552,406,522,8,71,0,0,4,392,324,-129,26,-71,22,-1290,-107
16:17.1,17,398,228,552,406,522,0,27,0,0,5,392,324,-129,9,-27,4,-1306,-125
16:17.1,17,412,279,567,432,523,0,27,0,0,5,419,288,-103,9,-27,4,-1360,-99
16:17.1,17,435,312,579,442,509,0,27,0,0,5,442,267,-67,9,-27,4,-1379,-63
16:17.1,17,435,312,579,442,509,0,24,0,0,4,442,267,-67,8,-24,4,-1381,-63
16:17.2,17,449,328,586,450,499,0,24,0,0,4,454,258,-44,8,-24,4,-1391,-40
16:17.2,17,449,328,586,450,499,0,3,0,0,3,454,258,-44,1,-3,-2,-1399,-46
16:17.2,17,455,337,590,453,482,0,3,0,0,3,460,253,-21,1,-3,-2,-1391,-23
16:17.3,17,455,337,590,453,482,0,1,0,0,5,460,253,-21,0,-1,-4,-1390,-26
16:17.3,17,455,337,590,453,482,0,0,0,0,5,460,253,-21,0,0,-5,-1390,-26
16:17.3,17,457,346,594,457,467,0,0,0,0,5,465,248,-1,0,0,-5,-1384,-6
16:17.3,17,426,366,601,463,450,0,0,0,0,5,464,235,14,0,0,-5,-1372,9
16:17.4,17,388,385,612,467,435,0,0,0,0,5,461,227,26,0,0,-5,-1358,21
16:17.4,17,388,385,612,467,435,9,0,0,0,5,461,227,26,3,0,-2,-1355,24
16:17.4,17,399,407,624,471,410,9,0,0,0,5,476,217,66,3,0,-2,-1349,64
16:17.4,17,399,407,624,471,410,7,0,0,0,3,476,217,66,2,0,0,-1352,66
16:17.4,17,399,407,624,471,410,6,4,1,0,5,476,217,66,3,-3,-1,-1349,65
16:17.4,17,422,422,636,471,309,6,4,1,0,5,493,214,184,3,-3,-1,-1264,183
16:17.5,18,422,422,636,471,309,0,1,2,0,13,493,214,184,1,1,-12,-1259,172
16:17.5,18,460,449,639,470,100,0,1,2,0,13,516,190,416,1,1,-12,-1072,404
16:17.5,18,460,449,639,470,100,0,21,29,0,238,516,190,416,16,8,-221,-831,194
16:17.5,18,480,487,622,412,30,0,21,29,0,238,529,135,499,16,8,-221,-717,278
16:17.6,18,480,487,622,412,30,16,86,246,314,415,529,135,499,116,160,-299,-126,200
16:17.6,18,480,487,622,412,30,47,161,365,429,467,529,135,499,191,204,-276,115,223
16:17.6,18,469,482,539,183,0,47,161,365,429,467,496,57,496,191,204,-276,407,220
16:17.6,18,375,372,394,59,0,47,161,365,429,467,380,22,380,191,204,-276,647,104
16:17.7,18,375,372,394,59,0,80,207,437,492,496,380,22,380,241,230,-254,790,125
16:17.7,18,375,372,394,59,0,110,256,467,529,514,380,22,380,277,211,-236,881,144
16:17.7,18,187,172,338,16,0,110,256,467,529,514,232,166,232,277,211,-236,1072,-4
16:17.7,18,42,84,101,0,0,110,256,467,529,514,75,17,75,277,211,-236,1245,-160
16:17.7,18,42,84,101,0,0,130,296,484,542,527,75,17,75,303,188,-223,1296,-148
16:17.8,18,42,84,101,0,0,191,342,491,545,523,75,17,75,341,149,-181,1333,-106
16:17.8,18,12,13,0,0,0,191,342,491,545,523,8,-13,8,341,149,-181,1401,-173
16:17.8,18,7,5,0,0,0,191,342,491,545,523,4,-5,4,341,149,-181,1405,-177
16:17.8,18,7,5,0,0,0,271,378,494,545,507,4,-5,4,381,116,-126,1429,-122
16:17.9,18,7,5,0,0,0,350,403,500,549,476,4,-5,4,417,97,-58,1438,-54
16:17.9,18,9,7,0,0,0,350,403,500,549,476,5,-7,5,417,97,-58,1437,-53
16:17.9,18,8,7,0,0,0,350,403,500,549,476,5,-7,5,417,97,-58,1437,-53
16:17.9,18,8,7,0,0,0,399,436,507,549,446,5,-7,5,447,71,1,1437,6
16:17.9,18,8,7,0,0,0,427,466,517,549,429,5,-7,5,470,51,41,1443,46
16:18.0,18,7,8,0,0,0,427,466,517,549,429,5,-8,5,470,51,41,1443,46
16:18.0,18,10,11,0,0,0,427,466,517,549,429,7,-11,7,470,51,41,1441,48
16:18.0,18,10,11,0,0,0,449,489,522,547,404,7,-11,7,486,33,82,1430,89
16:18.0,18,10,11,0,0,0,461,507,524,540,393,7,-11,7,497,17,104,1423,111
16:18.0,18,16,14,0,0,0,461,507,524,540,393,10,-14,10,497,17,104,1420,114
16:18.1,18,19,15,6,0,0,461,507,524,540,393,13,-9,13,497,17,104,1417,117
16:18.1,18,19,15,6,0,0,467,529,523,532,381,13,-9,13,506,-6,125,1406,138
16:18.1,18,19,15,6,0,0,503,554,535,527,306,13,-9,13,530,-19,224,1350,238
16:18.1,18,12,13,26,1,0,503,554,535,527,306,17,13,17,530,-19,224,1345,241
16:18.2,18,0,12,68,8,37,503,554,535,527,306,26,56,-10,530,-19,224,1291,214
16:18.2,18,0,12,68,8,37,550,581,558,513,132,26,56,-10,563,-23,431,1136,420
16:18.2,18,0,12,68,8,37,592,609,566,415,56,26,56,-10,589,-43,533,988,522
16:18.2,18,0,13,120,8,377,592,609,566,415,56,44,107,-332,589,-43,533,630,200
16:18.3,18,0,13,120,8,377,614,629,540,32,22,44,107,-332,594,-89,572,219,239
16:18.3,18,0,38,138,86,536,614,629,540,32,22,58,100,-477,594,-89,572,-32,95
16:18.3,18,0,38,138,86,536,612,599,415,0,5,58,100,-477,542,-184,537,-133,59
16:18.3,18,0,91,208,295,554,612,599,415,0,5,99,117,-454,542,-184,537,-401,82
16:18.4,18,0,91,208,295,554,565,556,203,0,7,99,117,-454,441,-353,434,-500,-20
16:18.4,18,22,238,229,439,554,565,556,203,0,7,163,-9,-391,441,-353,434,-707,43
16:18.4,18,48,358,198,534,554,565,556,203,0,7,201,-160,-352,441,-353,434,-841,81
16:18.4,18,48,358,198,534,554,388,464,51,0,8,201,-160,-352,301,-413,293,-980,-59
16:18.5,19,48,358,198,534,554,116,177,0,0,8,201,-160,-352,97,-177,89,-1183,-263
16:18.5,19,70,432,221,586,546,116,177,0,0,8,241,-211,-305,97,-177,89,-1267,-215
16:18.5,19,70,432,221,586,546,0,42,0,0,5,241,-211,-305,14,-42,9,-1354,-296
16:18.5,19,126,457,325,596,521,0,42,0,0,5,302,-132,-218,14,-42,9,-1400,-209
16:18.5,19,126,457,325,596,521,0,24,0,0,4,302,-132,-218,8,-24,4,-1407,-214
16:18.6,19,185,465,406,595,499,0,24,0,0,4,352,-59,-147,8,-24,4,-1434,-143
16:18.6,19,257,469,440,591,465,0,24,0,0,4,388,-29,-76,8,-24,4,-1432,-72
16:18.6,19,257,469,440,591,465,0,11,0,0,3,388,-29,-76,3,-11,0,-1438,-75
16:18.6,19,257,469,440,591,465,0,4,0,0,4,388,-29,-76,1,-4,-2,-1439,-79
16:18.7,19,302,478,475,590,432,0,4,0,0,4,418,-3,-13,1,-4,-2,-1435,-16
16:18.7,19,332,493,510,591,392,0,4,0,0,4,445,17,53,1,-4,-2,-1422,50
16:18.7,19,332,493,510,591,392,4,0,0,0,4,445,17,53,1,0,-2,-1422,50
16:18.7,19,332,493,510,591,392,9,0,0,0,5,445,17,53,3,0,-2,-1420,51
16:18.7,19,342,509,542,592,306,9,0,0,0,5,464,33,158,3,0,-2,-1354,156
16:18.8,19,363,530,571,595,182,9,0,0,0,5,488,41,306,3,0,-2,-1257,304
16:18.8,19,363,530,571,595,182,19,0,0,0,3,488,41,306,6,0,3,-1255,309
16:18.8,19,363,530,571,595,182,31,0,0,0,1,488,41,306,10,0,9,-1253,315
16:18.8,19,388,550,600,593,77,31,0,0,0,1,512,50,435,10,0,9,-1171,445
16:18.9,19,388,550,600,593,77,18,0,0,0,2,512,50,435,6,0,4,-1174,439
16:18.9,19,436,560,622,579,17,18,0,0,0,2,539,62,522,6,0,4,-1127,526
16:18.9,19,436,560,622,579,17,16,0,0,0,3,539,62,522,5,0,2,-1127,524
16:18.9,19,499,570,640,565,0,16,0,0,0,3,569,70,569,5,0,2,-1126,572
16:19.0,19,499,570,640,565,0,9,0,5,0,3,569,70,569,4,5,1,-1126,571
16:19.0,19,550,580,653,532,0,9,0,5,0,3,594,73,594,4,5,1,-1118,596
16:19.0,19,550,580,653,532,0,0,0,10,0,20,594,73,594,3,10,-16,-1103,577
16:19.0,19,585,584,660,419,0,0,0,10,0,20,609,76,609,3,10,-16,-1005,593
16:19.0,19,585,584,660,419,0,0,0,61,62,364,609,76,609,20,61,-343,-582,266
16:19.1,19,604,578,637,306,0,0,0,61,62,364,606,59,606,20,61,-343,-466,262
16:19.1,19,604,578,637,306,0,41,32,215,297,456,606,59,606,96,183,-360,-63,246
16:19.1,19,599,510,574,151,0,41,32,215,297,456,561,64,561,96,183,-360,137,201
16:19.1,19,599,510,574,151,0,155,156,296,354,505,561,64,561,202,140,-302,349,258
16:19.2,19,525,397,509,98,0,155,156,296,354,505,477,112,477,202,140,-302,486,174
16:19.2,19,525,397,509,98,0,273,250,336,428,545,477,112,477,286,86,-258,684,218
16:19.2,19,271,273,417,42,0,273,250,336,428,545,320,144,320,286,86,-258,897,61
16:19.2,19,271,273,417,42,0,361,332,400,494,552,320,144,320,364,68,-187,1048,132
16:19.3,19,92,141,161,28,0,361,332,400,494,552,131,20,131,364,68,-187,1251,-56
16:19.3,19,92,141,161,28,0,400,377,442,517,548,131,20,131,406,65,-141,1312,-10
16:19.3,19,10,12,0,11,0,400,377,442,517,548,7,-12,7,406,65,-141,1453,-134
16:19.3,19,10,12,0,11,0,394,405,464,532,534,7,-12,7,421,59,-113,1468,-105
16:19.3,19,28,2,0,1,0,394,405,464,532,534,10,-2,10,421,59,-113,1476,-103
16:19.4,19,28,2,0,1,0,367,438,470,531,518,10,-2,10,425,32,-93,1463,-83
16:19.4,19,25,7,0,0,0,367,438,470,531,518,10,-7,10,425,32,-93,1463,-82
16:19.4,19,25,7,0,0,0,387,478,478,526,484,10,-7,10,447,0,-36,1447,-25
16:19.4,19,26,6,0,0,0,387,478,478,526,484,10,-6,10,447,0,-36,1447,-25
16:19.4,19,26,6,0,0,0,441,508,481,521,443,10,-6,10,476,-27,33,1430,44
16:19.5,20,39,8,0,0,0,441,508,481,521,443,15,-8,15,476,-27,33,1425,49
16:19.5,20,49,15,0,1,0,441,508,481,521,443,21,-15,21,476,-27,33,1418,55
16:19.5,20,49,15,0,1,0,497,533,491,518,374,21,-15,21,507,-42,133,1376,154
16:19.5,20,49,15,0,1,0,547,558,506,522,282,21,-15,21,537,-52,255,1318,276
16:19.6,20,53,15,0,2,0,547,558,506,522,282,22,-15,22,537,-52,255,1316,277
16:19.6,20,53,15,0,2,0,583,579,537,525,136,22,-15,22,566,-42,430,1202,453
16:19.6,20,44,14,1,8,0,583,579,537,525,136,19,-13,19,566,-42,430,1199,450
16:19.6,20,44,14,1,8,0,608,598,567,504,59,19,-13,19,591,-31,532,1126,551
16:19.7,20,21,16,1,16,0,608,598,567,504,59,12,-15,12,591,-31,532,1125,544
16:19.7,20,21,16,1,16,0,629,611,577,421,43,12,-15,12,605,-34,562,1040,575
16:19.7,20,0,17,1,16,282,629,611,577,421,43,6,-16,-276,605,-34,562,765,286
16:19.7,20,0,17,1,16,282,640,610,575,179,21,6,-16,-276,608,-35,587,504,311
16:19.8,20,0,48,29,84,549,640,610,575,179,21,25,-19,-523,608,-35,587,149,64
16:19.8,20,0,48,29,84,549,637,568,498,0,6,25,-19,-523,567,-70,561,-85,38
16:19.8,20,63,102,265,253,573,637,568,498,0,6,143,163,-429,567,-70,561,-395,132
16:19.8,20,63,102,265,253,573,606,503,296,0,8,143,163,-429,468,-207,460,-493,30
16:19.9,20,63,102,265,253,573,431,416,79,0,13,143,163,-429,308,-337,295,-647,-134
16:19.9,20,182,172,418,292,585,431,416,79,0,13,257,246,-327,308,-337,295,-812,-32
16:19.9,20,231,211,449,361,595,431,416,79,0,13,297,238,-298,308,-337,295,-931,-2
16:19.9,20,231,211,449,361,595,173,172,0,0,15,297,238,-298,115,-172,100,-1123,-198
16:19.9,20,222,238,459,397,604,173,172,0,0,15,306,221,-297,115,-172,100,-1177,-197
16:20.0,20,222,238,459,397,604,0,18,0,0,8,306,221,-297,6,-18,-2,-1293,-299
16:20.0,20,165,259,469,415,608,0,18,0,0,8,297,210,-310,6,-18,-2,-1306,-312
16:20.0,20,165,259,469,415,608,0,13,0,0,10,297,210,-310,4,-13,-5,-1306,-316
16:20.0,20,112,277,483,426,606,0,13,0,0,10,290,206,-315,4,-13,-5,-1308,-321
16:20.0,20,112,277,483,426,606,0,5,0,0,7,290,206,-315,1,-5,-5,-1314,-320
16:20.1,20,89,311,472,437,597,0,5,0,0,7,290,161,-306,1,-5,-5,-1316,-311
16:20.1,20,89,311,472,437,597,0,5,0,0,5,290,161,-306,1,-5,-3,-1318,-309
16:20.1,20,69,336,474,446,587,0,5,0,0,5,293,138,-294,1,-5,-3,-1319,-297
16:20.1,20,69,336,474,446,587,0,6,0,0,5,293,138,-294,2,-6,-3,-1319,-297
16:20.2,20,73,358,500,456,576,0,6,0,0,5,310,142,-265,2,-6,-3,-1335,-268
16:20.2,20,73,358,500,456,576,0,5,0,0,3,310,142,-265,1,-5,-1,-1337,-267
16:20.2,20,72,384,550,468,548,0,5,0,0,3,335,166,-212,1,-5,-1,-1346,-214
16:20.2,20,72,384,550,468,548,1,1,0,0,3,335,166,-212,0,-1,-2,-1347,-215
16:20.3,20,138,421,586,484,504,1,1,0,0,3,381,165,-122,0,-1,-2,-1366,-124
16:20.3,20,138,421,586,484,504,5,3,0,0,3,381,165,-122,2,-3,0,-1364,-122
16:20.3,20,249,467,623,496,376,5,3,0,0,3,446,156,70,2,-3,0,-1312,70
16:20.3,20,249,467,623,496,376,6,6,0,0,3,446,156,70,4,-6,1,-1311,71
16:20.4,20,381,508,655,508,139,6,6,0,0,3,514,147,375,4,-6,1,-1154,376
16:20.4,20,381,508,655,508,139,6,9,0,0,3,514,147,375,5,-9,2,-1153,377
16:20.4,20,483,545,684,486,36,6,9,0,0,3,570,139,534,5,-9,2,-1084,536
16:20.4,20,483,545,684,486,36,0,0,0,0,0,570,139,534,0,0,0,-1092,534
16:20.4,20,550,561,707,347,2,0,0,0,0,0,606,146,604,0,0,0,-955,604
16:20.5,21,550,561,707,347,2,0,0,1,0,398,606,146,604,0,1,-397,-556,206
16:20.5,21,581,520,707,89,0,0,0,1,0,398,602,187,602,0,1,-397,-293,205
16:20.5,21,581,520,707,89,0,0,0,93,145,544,602,187,602,31,93,-513,28,89
16:20.5,21,588,334,642,0,0,0,0,93,145,544,521,308,521,31,93,-513,198,8
16:20.6,21,588,334,642,0,0,16,9,295,426,557,521,308,521,106,286,-450,568,71
16:20.6,21,458,163,607,0,0,16,9,295,426,557,409,444,409,106,286,-450,680,-41
16:20.6,21,458,163,607,0,0,40,28,361,491,592,409,444,409,143,333,-449,816,-39
16:20.6,21,122,87,358,0,0,40,28,361,491,592,189,271,189,143,333,-449,1037,-260
16:20.6,21,122,87,358,0,0,21,40,365,500,606,189,271,189,142,325,-464,1059,-275
16:20.7,21,0,5,0,0,0,21,40,365,500,606,1,-5,1,142,325,-464,1246,-462
16:20.7,21,0,5,0,0,0,3,88,334,477,613,1,-5,1,141,246,-471,1229,-469
16:20.7,21,10,2,0,0,0,3,88,334,477,613,4,-2,4,141,246,-471,1227,-467
16:20.7,21,10,2,0,0,0,1,157,293,431,618,4,-2,4,150,136,-467,1195,-463
16:20.7,21,10,6,0,0,0,1,157,293,431,618,5,-6,5,150,136,-467,1194,-462
16:20.8,21,10,6,0,0,0,1,194,261,396,622,5,-6,5,152,67,-470,1164,-464
16:20.8,21,13,4,0,0,0,1,194,261,396,622,5,-4,5,152,67,-470,1164,-464
16:20.8,21,13,4,0,0,0,2,239,256,390,621,5,-4,5,165,17,-455,1170,-449
16:20.9,21,13,4,0,0,0,14,317,291,417,612,5,-4,5,207,-26,-404,1230,-399
16:20.9,21,28,5,0,0,0,14,317,291,417,612,11,-5,11,207,-26,-404,1225,-393
16:20.9,21,37,12,0,0,0,14,317,291,417,612,16,-12,16,207,-26,-404,1220,-388
16:20.9,21,37,12,0,0,0,69,388,360,467,594,16,-12,16,272,-28,-321,1317,-305
16:20.9,21,37,12,0,0,0,215,469,435,500,541,16,-12,16,373,-34,-168,1397,-151
16:21.0,21,43,15,0,0,0,215,469,435,500,541,19,-15,19,373,-34,-168,1394,-148
16:21.0,21,7,14,0,3,0,215,469,435,500,541,7,-14,7,373,-34,-168,1404,-161
16:21.0,21,7,14,0,3,0,387,541,487,530,393,7,-14,7,471,-54,78,1384,85
16:21.0,21,7,14,0,3,0,501,586,556,531,146,7,-14,7,547,-30,401,1214,408
16:21.1,21,3,17,8,10,0,501,586,556,531,146,9,-9,9,547,-30,401,1205,411
16:21.1,21,0,12,0,8,280,501,586,556,531,146,4,-12,-276,547,-30,401,932,125
16:21.1,21,0,12,0,8,280,575,612,586,401,64,4,-12,-276,591,-26,527,764,251
16:21.1,21,0,12,0,8,280,606,579,549,0,4,4,-12,-276,578,-30,574,290,298
16:21.1,21,0,38,10,74,558,606,579,549,0,4,16,-28,-542,578,-30,574,-66,32
16:21.2,21,69,118,262,271,592,606,579,549,0,4,149,144,-442,578,-30,574,-430,131
16:21.2,21,69,118,262,271,592,574,511,331,0,3,149,144,-442,472,-180,469,-537,26
16:21.2,21,69,118,262,271,592,307,393,105,0,7,149,144,-442,268,-288,261,-737,-181
16:21.2,21,200,189,429,347,601,307,393,105,0,7,272,240,-328,268,-288,261,-945,-67
16:21.3,21,268,262,506,409,590,307,393,105,0,7,345,244,-244,268,-288,261,-1069,16
16:21.3,21,268,262,506,409,590,22,82,0,0,8,345,244,-244,34,-82,26,-1301,-218
16:21.3,21,268,262,506,409,590,0,11,0,0,4,345,244,-244,3,-11,0,-1336,-245
16:21.3,21,307,338,546,443,571,0,11,0,0,4,397,208,-174,3,-11,0,-1403,-174
16:21.3,21,294,402,571,476,518,0,11,0,0,4,422,169,-95,3,-11,0,-1408,-96
16:21.4,21,294,402,571,476,518,0,0,0,0,5,422,169,-95,0,0,-5,-1411,-100
16:21.4,21,282,443,595,495,405,0,0,0,0,5,440,152,35,0,0,-5,-1335,30
16:21.4,21,282,443,595,495,405,0,0,0,0,6,440,152,35,0,0,-6,-1334,29
16:21.4,21,282,443,595,495,405,0,0,0,0,7,440,152,35,0,0,-7,-1333,28
16:21.5,22,310,475,618,508,243,0,0,0,0,7,467,143,224,0,0,-7,-1211,217
16:21.5,22,375,502,635,515,103,0,0,0,0,7,504,133,401,0,0,-7,-1115,394
16:21.5,22,375,502,635,515,103,0,0,0,0,4,504,133,401,0,0,-4,-1118,397
16:21.5,22,375,502,635,515,103,3,0,0,0,4,504,133,401,1,0,-3,-1117,398
16:21.6,22,431,532,651,518,17,3,0,0,0,4,538,119,521,1,0,-3,-1068,518
16:21.6,22,486,559,668,510,3,3,0,0,0,4,571,109,568,1,0,-3,-1079,565
16:21.6,22,486,559,668,510,3,13,0,0,0,5,571,109,568,4,0,0,-1074,567
16:21.6,22,486,559,668,510,3,19,0,0,0,3,571,109,568,6,0,3,-1074,571
16:21.6,22,538,578,690,460,0,19,0,0,0,3,602,112,602,6,0,3,-1052,605
16:21.7,22,569,588,704,369,0,19,0,0,0,3,620,116,620,6,0,3,-980,623
16:21.7,22,569,588,704,369,0,10,0,0,0,0,620,116,620,3,0,3,-986,623
16:21.7,22,569,588,704,369,0,0,0,0,0,303,620,116,620,0,0,-303,-686,317
16:21.7,22,597,578,707,232,0,0,0,0,0,303,627,129,627,0,0,-303,-556,324
16:21.8,22,612,495,660,60,0,0,0,0,0,303,589,165,589,0,0,-303,-346,286
16:21.8,22,612,495,660,60,0,39,0,89,190,504,589,165,589,42,89,-461,87,127
16:21.8,22,612,495,660,60,0,268,154,325,372,513,589,165,589,249,171,-264,485,325
16:21.8,22,559,353,622,1,0,268,154,325,372,513,511,269,511,249,171,-264,621,247
16:21.9,22,266,161,493,0,0,268,154,325,372,513,306,332,306,249,171,-264,827,42
16:21.9,22,266,161,493,0,0,419,318,335,422,552,306,332,306,357,17,-194,1024,112
16:21.9,22,266,161,493,0,0,489,398,338,422,545,306,332,306,408,-60,-136,1068,170
16:21.9,22,33,88,61,0,0,489,398,338,422,545,60,-27,60,408,-60,-136,1314,-76
16:22.0,22,33,88,61,0,0,535,460,330,389,527,60,-27,60,441,-130,-85,1297,-24
16:22.0,22,4,3,0,0,0,535,460,330,389,527,2,-3,2,441,-130,-85,1355,-83
16:22.0,22,4,3,0,0,0,566,501,335,384,487,2,-3,2,467,-166,-19,1336,-17
16:22.0,22,19,4,0,0,0,566,501,335,384,487,7,-4,7,467,-166,-19,1330,-12
16:22.0,22,23,4,0,0,0,566,501,335,384,487,9,-4,9,467,-166,-19,1329,-10
16:22.0,22,23,4,0,0,0,589,528,338,383,451,9,-4,9,485,-190,34,1310,43
16:22.1,22,23,4,0,0,0,615,554,358,392,357,9,-4,9,509,-196,152,1249,161
16:22.1,22,50,3,0,0,0,615,554,358,392,357,17,-3,17,509,-196,152,1240,169
16:22.1,22,50,3,0,0,0,640,579,401,400,222,17,-3,17,540,-178,318,1144,335
16:22.2,22,92,2,0,0,0,640,579,401,400,222,31,-2,31,540,-178,318,1130,349
16:22.2,22,92,2,0,0,0,660,602,437,405,82,31,-2,31,566,-165,484,1022,515
16:22.2,22,109,2,0,0,0,660,602,437,405,82,37,-2,37,566,-165,484,1016,521
16:22.2,22,109,2,0,0,0,682,621,468,370,34,37,-2,37,590,-153,556,957,593
16:22.3,22,113,4,0,3,0,682,621,468,370,34,39,-4,39,590,-153,556,952,595
16:22.3,22,113,4,0,3,0,698,638,489,204,33,39,-4,39,608,-149,575,803,614
16:22.3,22,86,10,0,20,0,698,638,489,204,33,32,-10,32,608,-149,575,793,607
16:22.3,22,86,10,0,20,0,708,648,486,0,8,32,-10,32,614,-162,606,570,638
16:22.3,22,3,9,0,20,131,708,648,486,0,8,4,-9,-127,614,-162,606,467,479
16:22.3,22,3,9,0,20,131,709,611,442,0,8,4,-9,-127,587,-169,579,440,452
16:22.4,22,0,15,10,27,534,709,611,442,0,8,8,-5,-525,587,-169,579,26,53
16:22.4,22,0,15,10,27,534,680,559,272,0,8,8,-5,-525,503,-287,495,-57,-30
16:22.4,22,0,15,10,27,534,617,508,83,0,13,8,-5,-525,402,-425,389,-153,-136
16:22.5,22,32,105,353,252,587,617,508,83,0,13,163,248,-423,402,-425,389,-586,-34
16:22.5,22,264,208,533,342,582,617,508,83,0,13,335,325,-247,402,-425,389,-843,142
16:22.5,22,349,273,588,389,575,617,508,83,0,13,403,315,-171,402,-425,389,-951,218
16:22.5,22,349,273,588,389,575,330,214,0,0,13,403,315,-171,181,-214,168,-1173,-3
16:22.5,22,349,273,588,389,575,0,7,0,0,5,403,315,-171,2,-7,-2,-1360,-174
16:22.6,23,396,320,608,408,555,0,7,0,0,5,441,288,-113,2,-7,-2,-1397,-116
16:22.6,23,396,320,608,408,555,3,1,0,0,6,441,288,-113,1,-1,-4,-1397,-118
16:22.6,23,427,342,630,410,518,3,1,0,0,6,466,288,-51,1,-1,-4,-1387,-56
16:22.6,23,427,342,630,410,518,9,0,0,0,6,466,288,-51,3,0,-3,-1385,-54
16:22.6,23,487,359,642,409,443,9,0,0,0,6,496,283,53,3,0,-3,-1339,50
16:22.7,23,542,389,654,409,313,9,0,0,0,6,528,265,215,3,0,-3,-1241,212
16:22.7,23,542,389,654,409,313,8,0,0,0,5,528,265,215,2,0,-2,-1242,213
16:22.7,23,542,389,654,409,313,12,0,0,0,5,528,265,215,4,0,-1,-1241,214
16:22.7,23,588,412,664,402,138,12,0,0,0,5,554,252,416,4,0,-1,-1085,415
16:22.8,23,588,412,664,402,138,19,0,0,0,5,554,252,416,6,0,1,-1083,418
16:22.8,23,623,424,680,376,18,19,0,0,0,5,575,256,557,6,0,1,-958,559
16:22.8,23,623,424,680,376,18,64,0,0,0,4,575,256,557,21,0,17,-944,575
16:22.8,23,640,435,700,325,1,64,0,0,0,4,591,265,590,21,0,17,-892,608
16:22.9,23,640,435,700,325,1,66,0,0,0,4,591,265,590,22,0,18,-891,608
16:22.9,23,654,452,711,227,0,66,0,0,0,4,605,259,605,22,0,18,-806,623
16:22.9,23,654,452,711,227,0,35,0,0,0,2,605,259,605,11,0,9,-819,615
16:22.9,23,665,439,716,142,0,35,0,0,0,2,606,277,606,11,0,9,-735,616
16:23.0,23,665,439,716,142,0,9,0,0,0,46,606,277,606,3,0,-43,-699,563
16:23.0,23,672,392,712,62,0,9,0,0,0,46,592,320,592,3,0,-43,-605,549
16:23.0,23,672,392,712,62,0,0,0,17,0,470,592,320,592,5,17,-464,-178,127
16:23.0,23,668,283,681,14,0,0,0,17,0,470,544,398,544,5,17,-464,-82,79
16:23.1,23,668,283,681,14,0,0,24,129,308,547,544,398,544,51,105,-496,348,48
16:23.1,23,644,136,633,0,0,0,24,129,308,547,471,497,471,51,105,-496,435,-25
16:23.1,23,644,136,633,0,0,208,190,326,447,565,471,497,471,241,136,-323,782,147
16:23.1,23,644,136,633,0,0,370,320,350,477,578,471,497,471,346,30,-231,930,239
16:23.2,23,393,69,532,0,0,370,320,350,477,578,331,463,331,346,30,-231,1070,100
16:23.2,23,67,43,84,0,0,370,320,350,477,578,64,41,64,346,30,-231,1337,-166
16:23.2,23,67,43,84,0,0,422,373,381,483,562,64,41,64,392,8,-170,1372,-105
16:23.2,23,18,0,0,0,0,422,373,381,483,562,6,0,6,392,8,-170,1431,-164
16:23.2,23,18,0,0,0,0,456,400,412,493,540,6,0,6,422,12,-117,1449,-111
16:23.2,23,34,0,0,0,0,456,400,412,493,540,11,0,11,422,12,-117,1444,-106
16:23.3,23,34,0,0,0,0,496,444,432,490,497,11,0,11,457,-12,-39,1433,-28
16:23.3,23,34,0,0,0,0,533,478,444,490,447,11,0,11,485,-34,38,1410,49
16:23.3,23,22,0,0,0,0,533,478,444,490,447,7,0,7,485,-34,38,1414,45
16:23.3,23,43,0,0,0,0,533,478,444,490,447,14,0,14,485,-34,38,1407,52
16:23.4,23,43,0,0,0,0,566,511,461,499,343,14,0,14,512,-50,169,1340,184
16:23.4,23,71,2,0,0,0,566,511,461,499,343,24,-2,24,512,-50,169,1330,194
16:23.4,23,71,2,0,0,0,590,537,489,511,209,24,-2,24,538,-48,329,1234,354
16:23.5,23,92,3,0,0,0,590,537,489,511,209,31,-3,31,538,-48,329,1226,361
16:23.5,23,92,3,0,0,0,606,552,516,520,90,31,-3,31,558,-36,468,1136,499
16:23.5,23,92,4,0,0,0,606,552,516,520,90,32,-4,32,558,-36,468,1136,500
16:23.5,23,92,4,0,0,0,626,568,559,514,35,32,-4,32,584,-9,549,1101,581
16:23.6,24,59,5,0,6,0,626,568,559,514,35,21,-5,21,584,-9,549,1106,570
16:23.6,24,59,5,0,6,0,645,584,579,472,36,21,-5,21,602,-5,566,1083,588
16:23.6,24,27,12,2,9,0,645,584,579,472,36,13,-10,13,602,-5,566,1087,580
16:23.6,24,27,12,2,9,0,658,594,591,354,30,13,-10,13,614,-3,584,975,598
16:23.6,24,0,2,1,6,231,658,594,591,354,30,1,-1,-230,614,-3,584,760,354
16:23.7,24,0,15,6,23,527,658,594,591,354,30,7,-9,-520,614,-3,584,441,64
16:23.7,24,0,15,6,23,527,669,587,592,60,6,7,-9,-520,616,5,610,125,90
16:23.7,24,0,15,6,23,527,667,539,535,0,9,7,-9,-520,580,-4,571,32,51
16:23.7,24,0,15,6,23,527,626,488,374,0,10,7,-9,-520,496,-114,486,-51,-34
16:23.8,24,0,78,110,244,579,626,488,374,0,10,62,32,-516,496,-114,486,-379,-30
16:23.8,24,59,197,305,367,593,626,488,374,0,10,187,108,-406,496,-114,486,-641,80
16:23.8,24,59,197,305,367,593,458,400,190,0,13,187,108,-406,349,-210,336,-784,-69
16:23.8,24,74,283,395,443,595,458,400,190,0,13,250,112,-344,349,-210,336,-926,-8
16:23.8,24,74,283,395,443,595,181,158,35,0,13,250,112,-344,124,-123,111,-1150,-232
16:23.8,24,126,340,439,470,586,181,158,35,0,13,301,99,-284,124,-123,111,-1220,-172
16:23.9,24,126,340,439,470,586,0,9,0,0,6,301,99,-284,3,-9,-3,-1348,-287
16:23.9,24,159,364,484,481,581,0,9,0,0,6,335,120,-245,3,-9,-3,-1388,-248
16:23.9,24,159,364,484,481,581,0,0,0,0,6,335,120,-245,0,0,-6,-1391,-251
16:23.9,24,159,364,484,481,581,0,0,0,0,6,335,120,-245,0,0,-6,-1391,-251
16:24.0,24,158,370,514,479,570,0,0,0,0,6,347,144,-222,0,0,-6,-1390,-228
16:24.0,24,158,370,514,479,570,0,0,0,0,5,347,144,-222,0,0,-5,-1391,-227
16:24.0,24,160,380,525,482,554,0,0,0,0,5,355,145,-199,0,0,-5,-1386,-204
16:24.0,24,160,380,525,482,554,1,0,0,0,6,355,145,-199,0,0,-5,-1384,-204
16:24.1,24,165,401,542,493,530,1,0,0,0,6,369,141,-160,0,0,-5,-1386,-166
16:24.1,24,188,435,566,504,492,1,0,0,0,6,396,131,-95,0,0,-5,-1386,-101
16:24.1,24,188,435,566,504,492,8,0,0,0,5,396,131,-95,2,0,-2,-1384,-98
16:24.1,24,188,435,566,504,492,10,0,0,0,5,396,131,-95,3,0,-1,-1384,-97
16:24.1,24,252,464,590,515,409,10,0,0,0,5,435,126,26,3,0,-1,-1351,24
16:24.2,24,338,497,614,527,250,10,0,0,0,5,483,117,233,3,0,-1,-1251,231
16:24.2,24,338,497,614,527,250,12,0,0,0,4,483,117,233,4,0,0,-1252,233
16:24.2,24,416,531,643,530,76,12,0,0,0,4,530,112,454,4,0,0,-1128,454
16:24.2,24,416,531,643,530,76,14,0,0,0,4,530,112,454,4,0,0,-1127,454
16:24.3,24,490,559,662,519,17,14,0,0,0,4,570,103,553,4,0,0,-1097,554
16:24.3,24,490,559,662,519,17,6,0,0,0,2,570,103,553,2,0,0,-1102,553
16:24.3,24,490,559,662,519,17,0,0,0,0,232,570,103,553,0,0,-232,-874,321
16:24.3,24,547,578,683,437,0,0,0,0,0,232,602,105,602,0,0,-232,-807,370
16:24.3,24,574,571,696,257,0,0,0,0,0,232,613,125,613,0,0,-232,-638,381
16:24.4,24,574,571,696,257,0,0,0,52,0,510,613,125,613,17,52,-492,-343,121
16:24.4,24,574,571,696,257,0,0,1,239,343,528,613,125,613,80,238,-448,80,165
16:24.4,24,590,468,658,32,0,0,1,239,343,528,572,190,572,80,238,-448,347,124
16:24.4,24,562,281,624,0,0,0,1,239,343,528,489,343,489,80,238,-448,462,41
16:24.5,24,562,281,624,0,0,4,66,332,432,558,489,343,489,134,266,-424,635,65
16:24.5,24,298,118,558,0,0,4,66,332,432,558,324,440,324,134,266,-424,799,-99
16:24.5,24,298,118,558,0,0,14,85,372,485,580,324,440,324,157,287,-423,897,-98
16:24.5,24,66,78,208,0,0,14,85,372,485,580,117,130,117,157,287,-423,1104,-305
16:24.5,24,66,78,208,0,0,33,86,434,527,568,117,130,117,184,348,-383,1162,-266
16:24.6,25,0,0,0,0,0,33,86,434,527,568,0,0,0,184,348,-383,1279,-383
16:24.6,25,8,0,0,0,0,33,86,434,527,568,2,0,2,184,348,-383,1276,-381
16:24.6,25,8,0,0,0,0,67,90,473,561,559,2,0,2,210,383,-349,1327,-346
16:24.6,25,8,0,0,0,0,82,123,496,578,538,2,0,2,233,373,-304,1346,-301
16:24.7,25,6,0,0,0,0,82,123,496,578,538,2,0,2,233,373,-304,1347,-302
16:24.7,25,6,0,0,0,0,89,180,512,583,506,2,0,2,260,332,-245,1347,-243
16:24.7,25,6,0,0,0,0,123,276,530,582,458,2,0,2,309,254,-148,1347,-146
16:24.7,25,19,2,0,0,0,123,276,530,582,458,7,-2,7,309,254,-148,1342,-141
16:24.8,25,48,1,0,0,0,123,276,530,582,458,16,-1,16,309,254,-148,1333,-132
16:24.8,25,48,1,0,0,0,197,364,559,581,383,16,-1,16,373,195,-9,1321,6
16:24.8,25,48,1,0,0,0,297,402,579,587,283,16,-1,16,426,177,143,1279,159
16:24.8,25,64,7,0,0,0,297,402,579,587,283,23,-7,23,426,177,143,1272,166
16:24.9,25,64,7,0,0,0,383,457,593,585,147,23,-7,23,477,136,330,1186,354
16:24.9,25,86,11,0,0,0,383,457,593,585,147,32,-11,32,477,136,330,1177,363
16:24.9,25,86,11,0,0,0,453,506,602,563,78,32,-11,32,520,96,442,1129,474
16:24.9,25,72,13,0,2,0,453,506,602,563,78,28,-13,28,520,96,442,1131,470
16:24.9,25,45,13,0,4,0,453,506,602,563,78,19,-13,19,520,96,442,1138,461
16:25.0,25,45,13,0,4,0,527,549,608,517,36,19,-13,19,561,59,525,1091,544
16:25.0,25,0,13,0,4,107,527,549,608,517,36,4,-13,-102,561,59,525,999,422
16:25.0,25,0,13,0,4,107,581,575,610,414,37,4,-13,-102,588,35,551,924,449
16:25.0,25,0,22,2,21,520,581,575,610,414,37,8,-20,-512,588,35,551,490,39
16:25.1,25,0,22,2,21,520,613,586,598,30,6,8,-20,-512,599,12,593,86,81
16:25.1,25,0,22,2,21,520,622,536,467,0,9,8,-20,-512,541,-69,532,1,20
16:25.1,25,0,82,39,255,593,622,536,467,0,9,40,-43,-552,541,-69,532,-337,-20
16:25.1,25,0,185,112,387,604,622,536,467,0,9,99,-73,-505,541,-69,532,-539,27
16:25.1,25,0,185,112,387,604,565,481,253,0,8,99,-73,-505,433,-228,425,-649,-80
16:25.2,25,0,185,112,387,604,249,305,79,0,9,99,-73,-505,211,-226,202,-870,-303
16:25.2,25,1,263,127,458,610,249,305,79,0,9,130,-136,-479,211,-226,202,-978,-277
16:25.2,25,9,336,133,516,601,249,305,79,0,9,159,-203,-441,211,-226,202,-1056,-239
16:25.2,25,9,336,133,516,601,9,37,0,0,5,159,-203,-441,15,-37,10,-1256,-431
16:25.3,25,9,336,133,516,601,0,0,0,0,5,159,-203,-441,0,0,-5,-1271,-446
16:25.3,25,28,399,154,557,587,0,0,0,0,5,193,-245,-393,0,0,-5,-1332,-398
16:25.3,25,28,399,154,557,587,0,0,0,0,4,193,-245,-393,0,0,-4,-1333,-397
16:25.3,25,37,436,214,574,556,0,0,0,0,4,229,-222,-327,0,0,-4,-1355,-331
16:25.4,25,37,436,214,574,556,0,0,0,0,4,229,-222,-327,0,0,-4,-1355,-331
16:25.4,25,71,460,350,580,486,0,0,0,0,4,293,-110,-192,0,0,-4,-1355,-196
16:25.4,25,140,485,425,582,382,0,0,0,0,4,350,-60,-32,0,0,-4,-1310,-36
16:25.4,25,140,485,425,582,382,0,0,0,0,4,350,-60,-32,0,0,-4,-1310,-36
16:25.4,25,140,485,425,582,382,1,0,0,0,4,350,-60,-32,0,0,-3,-1309,-35
16:25.5,25,220,499,499,577,263,1,0,0,0,4,406,0,143,0,0,-3,-1241,139
16:25.5,25,220,499,499,577,263,7,0,0,0,4,406,0,143,2,0,-1,-1239,141
16:25.5,25,316,521,559,569,159,7,0,0,0,4,465,38,306,2,0,-1,-1187,304
16:25.5,25,371,536,603,557,73,7,0,0,0,4,503,67,430,2,0,-1,-1127,428
16:25.6,26,371,536,603,557,73,20,0,0,0,1,503,67,430,6,0,5,-1125,436
16:25.6,26,371,536,603,557,73,26,3,0,0,5,503,67,430,9,-3,4,-1118,435
16:25.6,26,431,554,635,527,11,26,3,0,0,5,540,81,529,9,-3,4,-1063,533
16:25.6,26,515,569,665,481,9,26,3,0,0,5,583,96,574,9,-3,4,-1058,578
16:25.7,26,515,569,665,481,9,10,6,0,0,3,583,96,574,5,-6,2,-1064,576
16:25.7,26,515,569,665,481,9,3,0,0,0,8,583,96,574,1,0,-7,-1064,567
16:25.7,26,562,578,688,383,0,3,0,0,0,8,609,110,609,1,0,-7,-983,602
16:25.7,26,592,559,695,220,0,3,0,0,0,8,615,136,615,1,0,-7,-826,608
16:25.8,26,592,559,695,220,0,0,0,11,0,433,615,136,615,3,11,-429,-398,186
16:25.8,26,592,559,695,220,0,0,0,92,138,553,615,136,615,30,92,-522,-113,93
16:25.8,26,608,441,652,35,0,0,0,92,138,553,567,211,567,30,92,-522,119,44
16:25.8,26,584,260,614,0,0,0,0,92,138,553,486,354,486,30,92,-522,235,-36
16:25.9,26,584,260,614,0,0,2,18,262,397,549,486,354,486,94,244,-455,554,31
16:25.9,26,584,260,614,0,0,18,49,339,483,581,486,354,486,135,290,-445,713,40
16:25.9,26,285,118,533,0,0,18,49,339,483,581,312,415,312,135,290,-445,887,-133
16:25.9,26,47,75,157,0,0,18,49,339,483,581,93,82,93,135,290,-445,1106,-352
16:26.0,26,47,75,157,0,0,23,35,370,521,592,93,82,93,142,335,-449,1162,-356
16:26.0,26,47,75,157,0,0,26,29,411,550,588,93,82,93,155,382,-432,1200,-339
16:26.0,26,0,3,0,0,0,26,29,411,550,588,1,-3,1,155,382,-432,1292,-431
16:26.0,26,0,3,0,0,0,29,30,437,566,589,1,-3,1,165,407,-423,1319,-422
16:26.0,26,17,1,0,0,0,29,30,437,566,589,6,-1,6,165,407,-423,1314,-417
16:26.0,26,17,1,0,0,0,35,45,461,578,581,6,-1,6,180,416,-400,1333,-394
16:26.1,26,22,3,0,0,0,35,45,461,578,581,8,-3,8,180,416,-400,1331,-392
16:26.1,26,22,3,0,0,0,52,74,478,585,567,8,-3,8,201,404,-365,1345,-357
16:26.1,26,39,3,0,0,0,52,74,478,585,567,14,-3,14,201,404,-365,1339,-351
16:26.1,26,39,3,0,0,0,64,142,496,588,538,14,-3,14,234,354,-304,1346,-290
16:26.2,26,52,3,0,0,0,64,142,496,588,538,18,-3,18,234,354,-304,1341,-285
16:26.2,26,52,3,0,0,0,112,246,515,591,491,18,-3,18,291,269,-200,1354,-181
16:26.2,26,64,5,0,0,0,112,246,515,591,491,23,-5,23,291,269,-200,1350,-177
16:26.2,26,64,5,0,0,0,224,359,544,588,421,23,-5,23,375,185,-45,1361,-22
16:26.3,26,68,10,0,0,0,224,359,544,588,421,26,-10,26,375,185,-45,1358,-19
16:26.3,26,68,10,0,0,0,329,431,566,575,309,26,-10,26,442,135,133,1300,159
16:26.3,26,52,12,0,3,0,329,431,566,575,309,21,-12,21,442,135,133,1301,154
16:26.3,26,52,12,0,3,0,424,493,584,559,145,21,-12,21,500,91,355,1180,376
16:26.3,26,39,13,0,0,0,424,493,584,559,145,17,-13,17,500,91,355,1187,372
16:26.4,26,39,13,0,0,0,511,541,601,530,66,17,-13,17,551,60,485,1129,502
16:26.4,26,0,12,0,1,1,511,541,601,530,66,4,-12,3,551,60,485,1141,488
16:26.4,26,0,12,0,1,1,569,566,610,439,38,4,-12,3,581,44,543,1052,546
16:26.4,26,0,9,2,7,372,569,566,610,439,38,3,-7,-368,581,44,543,675,175
16:26.5,26,0,9,2,7,372,602,570,606,48,5,3,-7,-368,592,36,587,262,219
16:26.5,26,0,46,3,76,580,602,570,606,48,5,16,-43,-563,592,36,587,-26,24
16:26.5,26,0,46,3,76,580,602,515,497,0,7,16,-43,-563,538,-18,531,-127,-32
16:26.5,26,0,126,87,309,604,602,515,497,0,7,71,-39,-533,538,-18,531,-439,-2
16:26.6,27,0,126,87,309,604,498,469,298,0,8,71,-39,-533,421,-171,413,-554,-119
16:26.6,27,0,126,87,309,604,181,259,102,0,9,71,-39,-533,180,-157,171,-794,-361
16:26.6,27,0,214,149,417,617,181,259,102,0,9,121,-65,-496,180,-157,171,-965,-324
16:26.6,27,21,306,183,479,615,181,259,102,0,9,170,-123,-445,180,-157,171,-1074,-273
16:26.6,27,21,306,183,479,615,0,21,0,0,6,170,-123,-445,7,-21,1,-1251,-444
16:26.7,27,51,379,230,522,600,0,21,0,0,6,220,-149,-380,7,-21,1,-1329,-379
16:26.7,27,51,379,230,522,600,0,0,0,0,6,220,-149,-380,0,0,-6,-1336,-386
16:26.7,27,93,436,280,559,567,0,0,0,0,6,269,-156,-297,0,0,-6,-1389,-303
16:26.7,27,93,436,280,559,567,0,0,0,0,5,269,-156,-297,0,0,-5,-1390,-302
16:26.7,27,171,470,354,576,475,0,0,0,0,5,331,-116,-143,0,0,-5,-1377,-148
16:26.8,27,171,470,354,576,475,0,0,0,0,5,331,-116,-143,0,0,-5,-1377,-148
16:26.8,27,226,503,405,585,346,0,0,0,0,5,378,-98,32,0,0,-5,-1304,27
16:26.8,27,226,503,405,585,346,0,0,0,0,4,378,-98,32,0,0,-4,-1305,28
16:26.8,27,281,531,463,588,218,0,0,0,0,4,425,-68,207,0,0,-4,-1227,203
16:26.9,27,281,531,463,588,218,2,0,0,0,4,425,-68,207,0,0,-3,-1226,203
16:26.9,27,328,553,527,589,110,2,0,0,0,4,469,-26,359,0,0,-3,-1163,356
16:26.9,27,328,553,527,589,110,9,0,0,0,4,469,-26,359,3,0,-1,-1161,358
16:26.9,27,371,568,569,588,47,9,0,0,0,4,502,1,455,3,0,-1,-1130,454
16:26.9,27,371,568,569,588,47,13,0,0,0,5,502,1,455,4,0,0,-1128,455
16:27.0,27,405,581,595,588,11,13,0,0,0,5,527,14,516,4,0,0,-1116,515
16:27.0,27,435,590,616,580,0,13,0,0,0,5,547,26,547,4,0,0,-1117,546
16:27.0,27,435,590,616,580,0,12,0,0,0,5,547,26,547,4,0,-1,-1118,546
16:27.1,27,435,590,616,580,0,5,1,0,0,5,547,26,547,2,-1,-3,-1120,544
16:27.1,27,489,593,637,545,0,5,1,0,0,5,573,44,573,2,-1,-3,-1111,570
16:27.1,27,535,596,653,437,0,5,1,0,0,5,594,57,594,2,-1,-3,-1024,591
16:27.1,27,535,596,653,437,0,0,4,0,0,3,594,57,594,1,-4,-1,-1027,593
16:27.2,27,535,596,653,437,0,0,0,0,0,213,594,57,594,0,0,-213,-818,381
16:27.2,27,570,591,652,301,0,0,0,0,0,213,604,61,604,0,0,-213,-692,391
16:27.2,27,570,591,652,301,0,0,0,36,0,506,604,61,604,12,36,-494,-387,110
16:27.2,27,589,547,625,117,0,0,0,36,0,506,587,78,587,12,36,-494,-186,93
16:27.2,27,589,547,625,117,0,0,0,125,255,552,587,78,587,41,125,-510,144,76
16:27.3,27,569,395,606,14,0,0,0,125,255,552,523,211,523,41,125,-510,311,13
16:27.3,27,569,395,606,14,0,4,22,289,411,579,523,211,523,105,267,-474,557,49
16:27.3,27,376,255,535,2,0,4,22,289,411,579,388,280,388,105,267,-474,704,-85
16:27.3,27,376,255,535,2,0,17,40,342,484,601,388,280,388,133,302,-468,827,-79
16:27.3,27,153,142,240,0,0,17,40,342,484,601,178,98,178,133,302,-468,1039,-289
16:27.4,27,153,142,240,0,0,5,32,352,501,610,178,98,178,129,320,-480,1062,-302
16:27.4,27,0,18,0,2,0,5,32,352,501,610,6,-18,6,129,320,-480,1232,-474
16:27.4,27,0,18,0,2,0,7,27,363,519,613,6,-18,6,132,336,-480,1256,-474
16:27.4,27,17,0,0,0,0,7,27,363,519,613,5,0,5,132,336,-480,1258,-475
16:27.5,27,17,0,0,0,0,8,30,368,525,614,5,0,5,135,338,-478,1268,-473
16:27.5,27,18,2,0,0,0,8,30,368,525,614,6,-2,6,135,338,-478,1267,-472
16:27.5,27,18,2,0,0,0,7,78,382,526,609,6,-2,6,155,304,-453,1283,-446
16:27.5,27,20,2,0,0,0,7,78,382,526,609,7,-2,7,155,304,-453,1283,-446
16:27.5,27,20,2,0,0,0,0,145,398,527,607,7,-2,7,181,253,-426,1307,-418
16:27.6,28,42,4,0,0,0,0,145,398,527,607,15,-4,15,181,253,-426,1299,-410
16:27.6,28,56,6,0,0,0,0,145,398,527,607,20,-6,20,181,253,-426,1294,-405
16:27.6,28,56,6,0,0,0,1,200,430,535,601,20,-6,20,210,230,-390,1325,-370
16:27.6,28,56,6,0,0,0,26,274,467,553,585,20,-6,20,255,193,-329,1372,-308
16:27.7,28,75,8,0,3,0,26,274,467,553,585,27,-8,27,255,193,-329,1362,-301
16:27.7,28,75,8,0,3,0,121,353,507,574,533,27,-8,27,327,154,-206,1403,-178
16:27.7,28,60,11,0,2,0,121,353,507,574,533,23,-11,23,327,154,-206,1408,-182
16:27.7,28,60,11,0,2,0,241,400,543,590,425,23,-11,23,394,143,-30,1384,-6
16:27.8,28,49,13,0,3,0,241,400,543,590,425,20,-13,20,394,143,-30,1386,-9
16:27.8,28,49,13,0,3,0,366,463,585,591,230,20,-13,20,471,122,241,1268,262
16:27.8,28,16,15,0,3,0,366,463,585,591,230,10,-15,10,471,122,241,1279,251
16:27.8,28,16,15,0,3,0,450,520,603,565,100,10,-15,10,524,83,424,1176,434
16:27.9,28,0,6,0,6,179,450,520,603,565,100,2,-6,-177,524,83,424,1002,247
16:27.9,28,0,6,0,6,179,533,560,613,485,44,2,-6,-177,568,53,524,910,347
16:27.9,28,0,6,0,6,179,584,576,612,164,21,2,-6,-177,590,36,569,588,392
16:28.0,28,0,11,12,14,509,584,576,612,164,21,7,1,-501,590,36,569,245,68
16:28.0,28,0,63,36,126,593,584,576,612,164,21,33,-27,-560,590,36,569,23,9
16:28.0,28,0,63,36,126,593,594,519,520,0,2,33,-27,-560,544,1,542,-205,-17
16:28.0,28,0,63,36,126,593,540,472,322,0,7,33,-27,-560,444,-150,437,-300,-122
16:28.0,28,2,107,172,276,605,540,472,322,0,7,93,65,-511,444,-150,437,-523,-73
16:28.0,28,47,160,308,336,618,540,472,322,0,7,171,148,-446,444,-150,437,-673,-8
16:28.1,28,47,160,308,336,618,266,380,148,0,7,171,148,-446,264,-232,257,-853,-188
16:28.1,28,47,160,308,336,618,52,105,11,0,9,171,148,-446,56,-94,47,-1060,-399
16:28.1,28,76,224,404,401,618,52,105,11,0,9,234,180,-383,56,-94,47,-1188,-336
16:28.1,28,121,276,456,433,616,52,105,11,0,9,284,180,-331,56,-94,47,-1268,-284
16:28.1,28,121,276,456,433,616,0,0,0,0,5,284,180,-331,0,0,-5,-1328,-336
16:28.2,28,121,276,456,433,616,0,0,0,0,6,284,180,-331,0,0,-6,-1327,-337
16:28.2,28,165,313,521,435,602,0,0,0,0,6,333,208,-269,0,0,-6,-1364,-275
16:28.2,28,183,318,557,429,586,0,0,0,0,6,352,239,-233,0,0,-6,-1361,-239
16:28.2,28,183,318,557,429,586,0,0,0,0,5,352,239,-233,0,0,-5,-1362,-238
16:28.3,28,183,318,557,429,586,0,0,0,0,6,352,239,-233,0,0,-6,-1361,-239
16:28.3,28,196,330,579,432,563,0,0,0,0,6,368,249,-194,0,0,-6,-1357,-200
16:28.3,28,214,350,597,440,533,0,0,0,0,6,387,247,-146,0,0,-6,-1354,-152
16:28.3,28,214,350,597,440,533,0,0,0,0,6,387,247,-146,0,0,-6,-1354,-152
16:28.4,28,270,388,615,448,471,0,0,0,0,6,424,227,-46,0,0,-6,-1337,-52
16:28.4,28,270,388,615,448,471,2,0,0,0,5,424,227,-46,0,0,-4,-1337,-51
16:28.4,28,348,417,639,460,385,2,0,0,0,5,468,222,83,0,0,-4,-1307,78
16:28.4,28,348,417,639,460,385,6,0,0,0,5,468,222,83,2,0,-3,-1306,80
16:28.5,28,415,440,658,461,243,6,0,0,0,5,504,218,261,2,0,-3,-1201,258
16:28.5,28,415,440,658,461,243,6,0,0,0,6,504,218,261,2,0,-4,-1200,257
16:28.5,28,472,468,676,457,87,6,0,0,0,6,538,208,451,2,0,-4,-1074,447
16:28.5,28,472,468,676,457,87,4,0,0,0,5,538,208,451,1,0,-3,-1076,448
16:28.6,29,526,481,700,430,15,4,0,0,0,5,569,219,554,1,0,-3,-1007,550
16:28.6,29,526,481,700,430,15,0,0,0,0,0,569,219,554,0,0,0,-1014,554
16:28.6,29,526,481,700,430,15,0,0,2,0,332,569,219,554,0,2,-331,-681,222
16:28.6,29,561,490,713,308,2,0,0,2,0,332,588,223,586,0,2,-331,-565,254
16:28.6,29,579,461,715,82,0,0,0,2,0,332,585,254,585,0,2,-331,-334,253
16:28.7,29,579,461,715,82,0,0,0,53,0,535,585,254,585,17,53,-517,-114,67
16:28.7,29,579,461,715,82,0,6,6,216,346,554,585,254,585,76,210,-478,309,107
16:28.7,29,583,302,672,0,0,6,6,216,346,554,519,370,519,76,210,-478,457,41
16:28.7,29,551,84,603,0,0,6,6,216,346,554,412,519,412,76,210,-478,563,-65
16:28.7,29,551,84,603,0,0,24,43,307,429,576,412,519,412,124,264,-451,716,-38
16:28.8,29,551,84,603,0,0,33,68,367,499,585,412,519,412,156,299,-429,827,-16
16:28.8,29,280,39,545,0,0,33,68,367,499,585,288,506,288,156,299,-429,952,-141
16:28.8,29,51,33,212,0,0,33,68,367,499,585,98,179,98,156,299,-429,1141,-330
16:28.9,29,51,33,212,0,0,48,123,440,548,578,98,179,98,203,317,-374,1230,-275
16:28.9,29,51,33,212,0,0,76,163,470,565,576,98,179,98,236,307,-339,1278,-241
16:28.9,29,0,2,0,0,0,76,163,470,565,576,0,-2,0,236,307,-339,1376,-339
16:28.9,29,1,0,2,0,0,76,163,470,565,576,1,2,1,236,307,-339,1376,-338
16:28.9,29,1,0,2,0,0,87,200,487,576,556,1,2,1,258,287,-298,1389,-297
16:29.0,29,1,0,2,0,0,114,260,501,579,529,1,2,1,291,241,-237,1398,-236
16:29.0,29,1,1,1,0,0,114,260,501,579,529,1,0,1,291,241,-237,1398,-236
16:29.0,29,8,3,0,0,0,114,260,501,579,529,3,-3,3,291,241,-237,1396,-233
16:29.0,29,8,3,0,0,0,143,299,512,583,490,3,-3,3,318,213,-172,1387,-168
16:29.0,29,8,3,0,0,0,198,353,527,588,454,3,-3,3,359,174,-94,1397,-91
16:29.1,29,9,10,0,0,0,198,353,527,588,454,6,-10,6,359,174,-94,1395,-88
16:29.1,29,8,14,0,0,0,198,353,527,588,454,7,-14,7,359,174,-94,1394,-87
16:29.1,29,8,14,0,0,0,251,388,554,592,403,7,-14,7,397,166,-5,1385,2
16:29.1,29,8,14,0,0,0,314,432,573,590,317,7,-14,7,439,141,122,1339,130
16:29.2,29,6,14,0,4,0,314,432,573,590,317,6,-14,6,439,141,122,1336,129
16:29.2,29,10,16,0,5,0,314,432,573,590,317,8,-16,8,439,141,122,1333,131
16:29.2,29,10,16,0,5,0,375,474,581,575,215,8,-16,8,476,107,261,1253,270
16:29.2,29,10,16,0,5,0,422,504,592,566,115,8,-16,8,506,88,391,1173,399
16:29.2,29,6,15,0,0,0,422,504,592,566,115,7,-15,7,506,88,391,1180,398
16:29.3,29,6,15,0,0,0,491,539,603,548,53,7,-15,7,544,64,491,1138,498
16:29.3,29,0,12,0,2,0,491,539,603,548,53,4,-12,4,544,64,491,1139,495
16:29.3,29,0,12,0,2,0,542,560,613,498,37,4,-12,4,571,53,534,1100,538
16:29.3,29,0,3,0,6,243,542,560,613,498,37,1,-3,-242,571,53,534,856,292
16:29.4,29,0,3,0,6,243,575,566,618,351,30,1,-3,-242,586,52,556,717,314
16:29.4,29,0,13,4,20,463,575,566,618,351,30,5,-9,-457,586,52,556,478,99
16:29.4,29,0,13,4,20,463,591,531,605,16,6,5,-9,-457,575,74,569,108,112
16:29.4,29,0,26,63,110,513,591,531,605,16,6,29,37,-483,575,74,569,-55,86
16:29.5,29,0,26,63,110,513,583,470,495,0,8,29,37,-483,516,25,508,-128,24
16:29.5,29,43,96,282,243,542,583,470,495,0,8,140,186,-401,516,25,508,-401,106
16:29.5,29,43,96,282,243,542,515,435,316,0,7,140,186,-401,422,-119,415,-496,13
16:29.5,29,165,149,423,297,568,515,435,316,0,7,245,274,-322,422,-119,415,-681,92
16:29.5,29,165,149,423,297,568,286,339,147,0,12,245,274,-322,257,-192,245,-841,-77
16:29.6,30,226,207,472,376,585,286,339,147,0,12,301,265,-283,257,-192,245,-993,-38
16:29.6,30,226,207,472,376,585,86,120,14,0,14,301,265,-283,73,-106,59,-1175,-224
16:29.6,30,258,259,525,420,591,86,120,14,0,14,347,266,-243,73,-106,59,-1271,-184
16:29.6,30,258,259,525,420,591,0,16,1,0,7,347,266,-243,5,-15,-1,-1345,-245
16:29.7,30,275,304,559,438,583,0,16,1,0,7,379,255,-203,5,-15,-1,-1387,-205
16:29.7,30,275,304,559,438,583,0,0,0,0,7,379,255,-203,0,0,-7,-1393,-210
16:29.7,30,283,340,580,449,568,0,0,0,0,7,401,240,-167,0,0,-7,-1411,-174
16:29.7,30,283,340,580,449,568,0,0,0,0,7,401,240,-167,0,0,-7,-1411,-174
16:29.8,30,295,352,592,459,535,0,0,0,0,7,413,240,-122,0,0,-7,-1400,-129
16:29.8,30,305,376,603,466,503,0,0,0,0,7,428,227,-75,0,0,-7,-1390,-82
16:29.8,30,305,376,603,466,503,0,0,0,0,7,428,227,-75,0,0,-7,-1390,-82
16:29.8,30,305,376,603,466,503,0,0,0,0,6,428,227,-75,0,0,-6,-1391,-81
16:29.8,30,318,401,618,475,453,0,0,0,0,6,445,217,-7,0,0,-6,-1367,-13
16:29.9,30,318,401,618,475,453,2,0,0,0,6,445,217,-7,0,0,-5,-1367,-12
16:29.9,30,351,423,636,481,387,2,0,0,0,6,470,213,83,0,0,-5,-1331,77
16:29.9,30,351,423,636,481,387,9,0,0,0,6,470,213,83,3,0,-3,-1329,80
16:29.9,30,392,450,652,487,282,9,0,0,0,6,498,202,216,3,0,-3,-1258,213
16:30.0,30,392,450,652,487,282,12,0,0,0,5,498,202,216,4,0,-1,-1258,215
16:30.0,30,445,479,666,492,132,12,0,0,0,5,530,187,398,4,0,-1,-1145,397
16:30.0,30,445,479,666,492,132,12,0,0,0,6,530,187,398,4,0,-2,-1144,396
16:30.0,30,513,495,677,483,35,12,0,0,0,6,561,182,526,4,0,-2,-1069,524
16:30.1,30,513,495,677,483,35,7,0,0,0,4,561,182,526,2,0,-1,-1073,525
16:30.1,30,553,515,691,450,14,7,0,0,0,4,586,176,572,2,0,-1,-1044,570
16:30.1,30,553,515,691,450,14,0,0,1,0,42,586,176,572,0,1,-41,-1008,530
16:30.1,30,576,527,702,361,0,0,0,1,0,42,601,175,601,0,1,-41,-920,560
16:30.2,30,576,527,702,361,0,0,0,48,0,412,601,175,601,16,48,-396,-534,205
16:30.2,30,592,518,692,177,0,0,0,48,0,412,600,174,600,16,48,-396,-349,204
16:30.2,30,592,518,692,177,0,15,9,264,384,500,600,174,600,96,255,-404,202,196
16:30.2,30,597,415,637,27,0,15,9,264,384,500,549,222,549,96,255,-404,403,145
16:30.2,30,597,415,637,27,0,114,92,346,441,500,549,222,549,184,254,-316,548,233
16:30.3,30,538,253,591,0,0,114,92,346,441,500,460,338,460,184,254,-316,664,144
16:30.3,30,538,253,591,0,0,213,178,375,478,516,460,338,460,255,197,-260,788,200
16:30.3,30,349,119,537,0,0,213,178,375,478,516,335,418,335,255,197,-260,914,74
16:30.3,30,349,119,537,0,0,349,273,426,507,503,335,418,335,349,153,-153,1024,181
16:30.3,30,165,73,338,0,0,349,273,426,507,503,192,265,192,349,153,-153,1167,38
16:30.4,30,165,73,338,0,0,445,361,454,520,486,192,265,192,420,93,-66,1234,126
16:30.4,30,30,27,28,0,0,445,361,454,520,486,28,1,28,420,93,-66,1397,-37
16:30.4,30,10,0,0,0,0,445,361,454,520,486,3,0,3,420,93,-66,1422,-62
