Timestamp,duration,left_1,left_2,left_3,left_4,left_5,right_1,right_2,right_3,right_4,right_5,FL,LX,LY,FR,RX,RY,Cop_X,Cop_Y
20:54.5,0,538,473,538,424,169,64,144,19,0,147,505,65,336,81,-125,-65,-870,271
20:54.5,0,562,485,556,373,95,64,144,19,0,147,520,71,425,81,-125,-65,-760,360
20:54.5,0,576,468,557,293,84,64,144,19,0,147,512,89,428,81,-125,-65,-661,363
20:54.6,0.1,576,468,557,293,84,75,113,56,0,632,512,89,428,84,-57,-547,-173,-119
20:54.6,0.1,577,369,519,201,80,75,113,56,0,632,444,150,364,84,-57,-547,-8,-183
20:54.6,0.1,577,369,519,201,80,61,137,205,2,638,444,150,364,171,68,-467,86,-103
20:54.6,0.1,556,228,376,124,87,61,137,205,2,638,302,148,215,171,68,-467,298,-252
20:54.7,0.2,556,228,376,124,87,17,274,318,125,643,302,148,215,296,44,-347,551,-132
20:54.7,0.2,309,154,201,123,88,17,274,318,125,643,177,47,89,296,44,-347,675,-257
20:54.7,0.2,309,154,201,123,88,0,341,351,184,649,177,47,89,346,10,-303,790,-213
20:54.7,0.2,67,97,143,104,95,0,341,351,184,649,120,46,25,346,10,-303,860,-278
20:54.8,0.3,67,97,143,104,95,0,412,352,216,647,120,46,25,382,-60,-265,926,-240
20:54.8,0.3,81,85,132,101,123,0,412,352,216,647,108,47,-14,382,-60,-265,912,-279
20:54.8,0.3,81,85,132,101,123,0,450,355,249,639,108,47,-14,402,-95,-236,958,-251
20:54.8,0.3,95,82,118,80,124,0,450,355,249,639,100,36,-24,402,-95,-236,986,-260
20:54.8,0.3,95,82,118,80,124,31,475,364,285,627,100,36,-24,419,-111,-207,1027,-231
20:54.8,0.3,91,75,116,58,124,31,475,364,285,627,95,41,-28,419,-111,-207,1054,-236
20:54.9,0.4,91,75,116,58,124,68,508,372,301,616,95,41,-28,440,-136,-176,1079,-204
20:54.9,0.4,93,72,111,50,120,68,508,372,301,616,91,39,-28,440,-136,-176,1095,-204
20:54.9,0.4,93,72,111,50,120,106,538,382,306,606,91,39,-28,460,-156,-146,1110,-174
20:55.0,0.5,98,64,105,46,113,106,538,382,306,606,84,41,-28,460,-156,-146,1128,-174
20:55.0,0.5,98,64,105,46,113,157,557,400,324,578,84,41,-28,478,-157,-99,1137,-128
20:55.0,0.5,100,61,105,34,103,157,557,400,324,578,83,44,-20,478,-157,-99,1160,-119
20:55.0,0.5,100,61,105,34,103,239,575,429,357,523,83,44,-20,502,-146,-21,1162,-41
20:55.0,0.5,101,45,97,31,95,239,575,429,357,523,71,52,-24,502,-146,-21,1185,-45
20:55.1,0.6,101,45,97,31,95,326,604,468,392,421,71,52,-24,536,-136,115,1152,91
20:55.1,0.6,101,45,97,31,95,370,627,511,378,303,71,52,-24,569,-116,266,1053,242
20:55.1,0.6,117,46,84,23,89,370,627,511,378,303,65,38,-24,569,-116,266,1073,242
20:55.1,0.6,77,56,67,17,406,370,627,511,378,303,61,11,-344,569,-116,266,765,-78
20:55.2,0.7,77,56,67,17,406,396,639,531,269,129,61,11,-344,585,-108,456,498,111
20:55.2,0.7,78,40,59,18,592,396,639,531,269,129,49,19,-542,585,-108,456,323,-86
20:55.2,0.7,78,40,59,18,592,466,600,511,97,134,49,19,-542,555,-89,421,127,-121
20:55.2,0.7,133,209,103,162,596,466,600,511,97,134,156,-106,-440,555,-89,421,-127,-18
20:55.3,0.8,133,209,103,162,596,493,493,379,57,134,156,-106,-440,436,-114,302,-287,-138
20:55.3,0.8,133,209,103,162,596,388,360,184,69,137,156,-106,-440,272,-176,135,-436,-305
20:55.3,0.8,220,262,190,244,598,388,360,184,69,137,226,-72,-372,272,-176,135,-590,-237
20:55.3,0.8,275,300,268,319,588,388,360,184,69,137,284,-32,-304,272,-176,135,-713,-169
20:55.3,0.8,275,300,268,319,588,148,185,140,61,134,284,-32,-304,162,-45,28,-833,-275
20:55.4,0.9,275,300,268,319,588,80,144,108,56,159,284,-32,-304,126,-36,-33,-850,-337
20:55.4,0.9,275,300,268,319,588,71,151,104,37,159,284,-32,-304,127,-47,-31,-867,-335
20:55.5,1,345,351,313,363,573,71,151,104,37,159,332,-38,-241,127,-47,-31,-944,-272
20:55.5,1,345,351,313,363,573,71,158,81,23,157,332,-38,-241,119,-77,-37,-968,-278
20:55.5,1,391,403,356,402,552,71,158,81,23,157,379,-47,-172,119,-77,-37,-1034,-210
20:55.5,1,416,428,395,443,532,71,158,81,23,157,411,-33,-120,119,-77,-37,-1087,-158
20:55.5,1,437,443,431,465,494,71,158,81,23,157,437,-12,-57,119,-77,-37,-1096,-94
20:55.5,1,437,443,431,465,494,69,169,63,16,157,437,-12,-57,116,-106,-41,-1107,-98
20:55.5,1,454,455,465,471,430,69,169,63,16,157,460,10,30,116,-106,-41,-1072,-11
20:55.6,1.1,454,455,465,471,430,65,174,52,13,150,460,10,30,113,-122,-37,-1085,-7
20:55.6,1.1,470,454,489,473,360,65,174,52,13,150,471,35,111,113,-122,-37,-1028,74
20:55.6,1.1,470,454,489,473,360,62,179,37,6,147,471,35,111,108,-142,-39,-1043,72
20:55.7,1.2,470,454,489,473,360,60,182,32,6,144,471,35,111,107,-150,-37,-1047,74
20:55.7,1.2,497,466,517,471,295,60,182,32,6,144,491,51,196,107,-150,-37,-1000,159
20:55.7,1.2,529,483,544,447,147,60,182,32,6,144,513,61,366,107,-150,-37,-850,329
20:55.7,1.2,555,491,555,377,92,60,182,32,6,144,523,64,431,107,-150,-37,-735,394
20:55.8,1.3,562,450,539,279,87,60,182,32,6,144,494,89,407,107,-150,-37,-603,370
20:55.8,1.3,562,450,539,279,87,57,144,32,0,171,494,89,407,88,-112,-83,-601,324
20:55.8,1.3,562,450,539,279,87,62,112,39,0,511,494,89,407,75,-73,-435,-274,-28
20:55.8,1.3,562,450,539,279,87,40,270,217,14,612,494,89,407,243,-53,-368,9,39
20:55.8,1.3,558,333,468,178,84,40,270,217,14,612,400,135,316,243,-53,-368,207,-52
20:55.9,1.4,558,333,468,178,84,0,381,300,102,602,400,135,316,340,-81,-261,382,55
20:55.9,1.4,492,203,269,132,94,0,381,300,102,602,236,66,142,340,-81,-261,582,-119
20:55.9,1.4,492,203,269,132,94,0,425,312,134,610,236,66,142,368,-113,-241,650,-99
20:55.9,1.4,183,127,152,120,98,0,425,312,134,610,139,25,41,368,-113,-241,755,-200
20:55.9,1.4,183,127,152,120,98,26,475,332,186,590,139,25,41,403,-143,-186,822,-145
20:56.0,1.5,65,89,126,106,128,26,475,332,186,590,107,37,-20,403,-143,-186,838,-207
20:56.0,1.5,65,89,126,106,128,84,501,367,255,574,107,37,-20,434,-134,-140,921,-160
20:56.0,1.5,86,93,121,103,133,84,501,367,255,574,107,28,-26,434,-134,-140,920,-166
20:56.0,1.5,92,82,115,81,134,84,501,367,255,574,98,33,-35,434,-134,-140,949,-175
20:56.1,1.6,92,82,115,81,134,136,517,379,298,567,98,33,-35,448,-138,-119,999,-154
20:56.1,1.6,92,82,115,81,134,207,537,406,328,552,98,33,-35,471,-131,-80,1038,-116
20:56.1,1.6,84,76,112,58,129,207,537,406,328,552,94,36,-35,471,-131,-80,1070,-115
20:56.1,1.6,80,73,109,50,125,207,537,406,328,552,91,36,-34,471,-131,-80,1085,-114
20:56.3,1.8,89,66,106,45,120,207,537,406,328,552,86,40,-34,471,-131,-80,1100,-114
20:56.3,1.8,99,58,100,40,103,207,537,406,328,552,79,42,-24,471,-131,-80,1129,-104
20:56.3,1.8,99,58,100,40,103,264,553,427,352,521,79,42,-24,490,-126,-31,1141,-55
20:56.3,1.8,99,58,100,40,103,302,565,444,367,484,79,42,-24,504,-121,20,1133,-3
20:56.3,1.8,93,49,91,32,93,302,565,444,367,484,70,42,-23,504,-121,20,1160,-2
20:56.3,1.8,93,49,91,32,93,347,588,477,388,416,70,42,-23,532,-111,116,1141,93
20:56.3,1.8,93,49,91,32,93,390,616,513,404,335,70,42,-23,564,-103,229,1108,206
20:56.3,1.8,93,49,91,32,93,425,629,538,381,192,70,42,-23,583,-91,391,961,368
20:56.3,1.8,93,49,91,32,93,443,634,553,314,109,70,42,-23,593,-81,484,821,461
20:56.3,1.8,78,56,73,23,181,443,634,553,314,109,64,17,-116,593,-81,484,748,368
20:56.4,1.9,78,68,62,17,584,443,634,553,314,109,65,-6,-519,593,-81,484,350,-34
20:56.4,1.9,78,68,62,17,584,483,581,540,146,118,65,-6,-519,560,-41,442,158,-76
20:56.4,1.9,94,186,76,140,595,483,581,540,146,118,131,-110,-464,560,-41,442,-41,-21
20:56.5,2,94,186,76,140,595,511,443,474,65,115,131,-110,-464,458,31,343,-227,-120
20:56.5,2,94,186,76,140,595,459,270,245,73,120,131,-110,-464,257,-25,137,-415,-326
20:56.5,2,94,186,76,140,595,227,158,167,64,122,131,-110,-464,162,9,40,-517,-423
20:56.6,2.1,221,270,196,251,600,227,158,167,64,122,233,-74,-367,162,9,40,-735,-326
20:56.6,2.1,278,293,247,292,604,227,158,167,64,122,270,-46,-334,162,9,40,-817,-293
20:56.6,2.1,369,326,314,338,594,227,158,167,64,122,320,-12,-274,162,9,40,-903,-233
20:56.6,2.1,369,326,314,338,594,111,79,133,61,140,320,-12,-274,106,54,-34,-945,-308
20:56.6,2.1,369,326,314,338,594,87,119,108,53,145,320,-12,-274,113,-11,-31,-940,-305
20:56.7,2.2,369,326,314,338,594,83,136,91,34,149,320,-12,-274,113,-45,-35,-955,-309
20:56.7,2.2,422,372,355,366,581,83,136,91,34,149,363,-17,-217,113,-45,-35,-1014,-253
20:56.7,2.2,459,420,408,403,560,83,136,91,34,149,414,-12,-146,113,-45,-35,-1080,-181
20:56.7,2.2,485,437,441,420,533,83,136,91,34,149,439,4,-94,113,-45,-35,-1095,-129
20:56.7,2.2,485,437,441,420,533,84,150,78,19,151,439,4,-94,114,-72,-37,-1108,-131
20:56.7,2.2,502,447,462,426,496,84,150,78,19,151,454,15,-41,114,-72,-37,-1092,-78
20:56.8,2.3,502,447,462,426,496,81,166,61,13,149,454,15,-41,113,-105,-35,-1101,-77
20:56.8,2.3,502,447,462,426,496,76,168,55,10,145,454,15,-41,111,-113,-33,-1110,-75
20:56.8,2.3,502,447,462,426,496,71,166,46,5,135,454,15,-41,106,-120,-29,-1130,-70
20:56.9,2.4,521,451,482,431,450,71,166,46,5,135,466,31,16,106,-120,-29,-1101,-12
20:56.9,2.4,541,458,501,446,380,71,166,46,5,135,479,43,99,106,-120,-29,-1059,70
20:56.9,2.4,541,458,501,446,380,70,162,42,3,123,479,43,99,102,-120,-21,-1077,78
20:56.9,2.4,556,475,528,446,303,70,162,42,3,123,501,53,198,102,-120,-21,-1022,177
20:56.9,2.4,570,487,554,418,161,70,162,42,3,123,520,67,359,102,-120,-21,-871,338
20:57.0,2.5,570,487,554,418,161,66,118,53,0,266,520,67,359,85,-65,-180,-748,179
20:57.0,2.5,579,493,564,363,100,66,118,53,0,266,528,71,428,85,-65,-180,-640,248
20:57.0,2.5,579,493,564,363,100,67,110,83,0,613,528,71,428,96,-27,-516,-282,-88
20:57.0,2.5,579,446,545,256,93,67,110,83,0,613,495,99,402,96,-27,-516,-135,-114
20:57.1,2.6,574,324,490,161,95,67,110,83,0,613,407,166,312,96,-27,-516,46,-204
20:57.1,2.6,574,324,490,161,95,59,154,131,0,621,407,166,312,142,-23,-478,100,-166
20:57.1,2.6,574,324,490,161,95,14,360,223,41,618,407,166,312,291,-137,-326,287,-14
20:57.1,2.6,549,196,331,128,100,14,360,223,41,618,263,135,163,291,-137,-326,459,-163
20:57.1,2.6,549,196,331,128,100,0,434,247,77,623,263,135,163,340,-187,-282,549,-119
20:57.1,2.6,340,125,204,122,102,0,434,247,77,623,164,79,62,340,-187,-282,652,-220
20:57.2,2.7,340,125,204,122,102,81,483,286,137,617,164,79,62,384,-197,-232,750,-170
20:57.2,2.7,63,87,148,104,122,81,483,286,137,617,117,61,-4,384,-197,-232,795,-237
20:57.2,2.7,63,87,148,104,122,151,512,320,190,614,117,61,-4,416,-192,-198,876,-202
20:57.3,2.8,82,92,143,98,132,151,512,320,190,614,117,51,-14,416,-192,-198,872,-212
20:57.3,2.8,82,92,143,98,132,253,529,355,257,600,117,51,-14,442,-174,-158,951,-172
20:57.3,2.8,85,86,129,74,134,253,529,355,257,600,107,43,-26,442,-174,-158,983,-184
20:57.3,2.8,85,86,129,74,134,307,541,382,291,580,107,43,-26,461,-159,-118,1017,-145
20:57.4,2.9,98,80,122,55,132,307,541,382,291,580,101,42,-31,461,-159,-118,1044,-149
20:57.4,2.9,98,80,122,55,132,343,554,406,313,550,101,42,-31,480,-148,-70,1055,-101
20:57.4,2.9,110,72,119,46,125,343,554,406,313,550,95,47,-29,480,-148,-70,1076,-99
20:57.4,2.9,113,62,116,47,121,343,554,406,313,550,89,54,-32,480,-148,-70,1086,-102
20:57.4,2.9,113,62,116,47,121,365,567,428,335,520,89,54,-32,497,-139,-22,1095,-54
20:57.5,3,113,62,116,47,121,398,584,449,360,494,89,54,-32,516,-135,22,1113,-9
20:57.5,3,124,51,110,38,107,398,584,449,360,494,80,59,-26,516,-135,22,1145,-4
20:57.5,3,124,51,110,38,107,428,602,473,383,430,80,59,-26,537,-129,107,1125,81
20:57.6,3.1,124,51,110,38,107,466,618,501,397,351,80,59,-26,559,-117,208,1082,182
20:57.6,3.1,124,51,110,38,107,488,624,533,376,188,80,59,-26,578,-91,390,917,364
20:57.6,3.1,121,42,110,34,94,488,624,533,376,188,76,68,-18,578,-91,390,938,372
20:57.6,3.1,100,51,82,22,146,488,624,533,376,188,66,31,-79,578,-91,390,908,311
20:57.6,3.1,83,69,70,17,495,488,624,533,376,188,69,1,-425,578,-91,390,561,-35
20:57.7,3.2,83,69,70,17,495,517,621,545,270,124,69,1,-425,583,-76,459,395,33
20:57.7,3.2,83,69,70,17,495,535,550,506,103,130,69,1,-425,528,-44,398,179,-27
20:57.7,3.2,78,57,61,39,583,535,550,506,103,130,59,4,-524,528,-44,398,80,-126
20:57.7,3.2,223,216,197,154,588,535,550,506,103,130,206,-19,-381,528,-44,398,-187,16
20:57.7,3.2,223,216,197,154,588,539,407,380,62,128,206,-19,-381,393,-27,265,-365,-116
20:57.8,3.3,223,216,197,154,588,458,233,200,67,132,206,-19,-381,216,-33,84,-533,-297
20:57.8,3.3,330,268,263,234,590,458,233,200,67,132,265,-5,-324,216,-33,84,-674,-240
20:57.8,3.3,433,307,311,290,584,458,233,200,67,132,309,4,-275,216,-33,84,-767,-190
20:57.9,3.4,433,307,311,290,584,247,123,166,59,131,309,4,-275,144,43,13,-848,-261
20:57.9,3.4,433,307,311,290,584,113,102,131,52,139,309,4,-275,116,29,-22,-875,-297
20:57.9,3.4,483,356,335,338,578,113,102,131,52,139,345,-21,-232,116,29,-22,-954,-255
20:57.9,3.4,509,389,349,367,585,113,102,131,52,139,369,-40,-216,116,29,-22,-1013,-238
20:57.9,3.4,509,389,349,367,585,101,136,113,39,143,369,-40,-216,124,-23,-18,-1014,-234
20:58.0,3.5,524,412,374,392,583,101,136,113,39,143,393,-38,-190,124,-23,-18,-1061,-208
20:58.0,3.5,524,412,374,392,583,89,154,91,29,145,393,-38,-190,122,-63,-22,-1071,-212
20:58.0,3.5,536,435,412,415,553,89,154,91,29,145,423,-23,-129,122,-63,-22,-1095,-152
20:58.0,3.5,536,435,412,415,553,89,162,68,19,144,423,-23,-129,115,-94,-29,-1113,-158
20:58.0,3.5,547,445,439,430,518,89,162,68,19,144,442,-6,-76,115,-94,-29,-1112,-105
20:58.1,3.6,547,445,439,430,518,84,168,54,12,144,442,-6,-76,111,-114,-33,-1123,-109
20:58.1,3.6,556,446,463,435,460,84,168,54,12,144,454,17,-5,111,-114,-33,-1082,-38
20:58.1,3.6,556,446,463,435,460,83,178,41,9,141,454,17,-5,109,-137,-31,-1090,-37
20:58.2,3.7,568,442,485,447,398,83,178,41,9,141,463,43,65,109,-137,-31,-1049,34
20:58.2,3.7,580,446,500,452,331,83,178,41,9,141,473,54,142,109,-137,-31,-996,110
20:58.2,3.7,580,446,500,452,331,79,180,37,7,135,473,54,142,108,-143,-26,-1005,115
20:58.2,3.7,580,446,500,452,331,78,187,33,5,119,473,54,142,110,-154,-9,-1022,133
20:58.2,3.7,586,453,520,429,196,78,187,33,5,119,486,67,290,110,-154,-9,-877,281
20:58.3,3.8,586,453,520,429,196,65,145,46,2,168,486,67,290,95,-99,-72,-846,218
20:58.3,3.8,581,470,528,398,108,65,145,46,2,168,499,58,391,95,-99,-72,-739,318
20:58.3,3.8,581,470,528,398,108,45,238,203,44,540,499,58,391,220,-35,-319,-200,71
20:58.3,3.8,584,472,464,318,98,45,238,203,44,540,468,-8,370,220,-35,-319,-79,50
20:58.3,3.8,590,369,231,198,95,45,238,203,44,540,300,-138,205,220,-35,-319,211,-114
20:58.4,3.9,590,369,231,198,95,26,355,261,52,500,300,-138,205,308,-94,-192,267,13
20:58.4,3.9,590,369,231,198,95,55,386,302,122,545,300,-138,205,344,-84,-201,418,4
20:58.4,3.9,558,218,123,134,98,55,386,302,122,545,170,-95,72,344,-84,-201,608,-128
20:58.4,3.9,558,218,123,134,98,74,418,319,170,557,170,-95,72,368,-99,-188,693,-116
20:58.5,4,334,161,75,130,100,74,418,319,170,557,118,-86,18,368,-99,-188,747,-170
20:58.5,4,73,97,111,108,125,74,418,319,170,557,104,14,-21,368,-99,-188,758,-209
20:58.5,4,95,95,117,104,135,74,418,319,170,557,106,22,-29,368,-99,-188,750,-217
20:58.6,4.1,103,86,115,89,138,74,418,319,170,557,100,29,-37,368,-99,-188,768,-226
20:58.6,4.1,103,86,115,89,138,86,441,344,212,545,100,29,-37,392,-97,-152,822,-190
20:58.6,4.1,103,86,115,89,138,114,470,372,269,539,100,29,-37,421,-98,-118,901,-155
20:58.6,4.1,103,86,115,89,138,149,493,392,301,521,100,29,-37,442,-101,-78,937,-116
20:58.6,4.1,103,86,115,89,138,169,502,411,330,516,100,29,-37,456,-91,-59,975,-97
20:58.6,4.1,103,76,113,71,137,169,502,411,330,516,94,37,-42,456,-91,-59,1000,-102
20:58.7,4.2,104,66,112,58,132,169,502,411,330,516,89,46,-43,456,-91,-59,1023,-102
20:58.7,4.2,104,66,112,58,132,184,507,414,348,512,89,46,-43,460,-93,-51,1041,-94
20:58.7,4.2,104,66,112,58,132,215,507,423,378,501,89,46,-43,465,-84,-36,1065,-79
20:58.7,4.2,104,66,112,58,132,228,504,445,397,494,89,46,-43,474,-59,-19,1086,-62
20:58.7,4.2,109,56,106,53,130,228,504,445,397,494,81,50,-49,474,-59,-19,1101,-68
20:58.8,4.3,107,56,100,49,108,228,504,445,397,494,78,44,-30,474,-59,-19,1130,-49
20:58.8,4.3,105,48,104,34,105,228,504,445,397,494,76,56,-29,474,-59,-19,1150,-48
20:58.9,4.4,105,48,104,34,105,256,509,493,412,465,76,56,-29,501,-16,36,1163,7
20:58.9,4.4,105,48,104,34,105,278,518,517,419,382,76,56,-29,517,-1,135,1103,106
20:58.9,4.4,105,48,104,34,105,284,520,528,405,283,76,56,-29,524,8,241,997,212
20:58.9,4.4,160,89,200,40,232,284,520,528,405,283,144,111,-87,524,8,241,795,153
20:58.9,4.4,330,123,294,90,332,284,520,528,405,283,208,171,-123,524,8,241,581,117
20:59.0,4.5,330,123,294,90,332,265,507,539,358,112,208,171,-123,523,32,411,362,287
20:59.0,4.5,441,176,337,133,352,265,507,539,358,112,256,161,-95,523,32,411,251,315
20:59.0,4.5,441,176,337,133,352,244,502,539,283,87,256,161,-95,520,37,433,149,338
20:59.1,4.6,441,176,337,133,352,208,470,511,190,92,256,161,-95,490,41,398,31,303
20:59.1,4.6,441,176,337,133,352,132,382,462,125,94,256,161,-95,422,80,328,-100,232
20:59.1,4.6,441,176,337,133,352,25,252,388,83,96,256,161,-95,320,136,224,-242,128
20:59.1,4.6,478,223,399,217,382,25,252,388,83,96,311,176,-71,320,136,224,-411,153
20:59.2,4.7,478,223,399,217,382,37,133,207,66,101,311,176,-71,170,74,69,-573,-2
20:59.2,4.7,478,223,399,217,382,41,131,181,56,103,311,176,-71,156,50,53,-595,-18
20:59.2,4.7,504,258,427,292,392,41,131,181,56,103,342,169,-49,156,50,53,-711,3
20:59.2,4.7,520,302,447,340,401,41,131,181,56,103,374,145,-26,156,50,53,-800,26
20:59.2,4.7,529,350,458,380,419,41,131,181,56,103,404,108,-15,156,50,53,-888,38
20:59.2,4.7,527,381,467,413,466,41,131,181,56,103,424,86,-42,156,50,53,-988,11
20:59.2,4.7,529,412,476,448,459,41,131,181,56,103,444,64,-15,156,50,53,-1036,38
20:59.3,4.8,529,412,476,448,459,46,129,154,46,112,444,64,-15,141,25,29,-1051,14
20:59.3,4.8,529,412,476,448,459,48,138,131,32,121,444,64,-15,134,-7,13,-1063,-1
20:59.3,4.8,526,428,484,459,451,48,138,131,32,121,456,56,5,134,-7,13,-1078,18
20:59.3,4.8,512,435,485,460,454,48,138,131,32,121,460,50,6,134,-7,13,-1086,19
20:59.3,4.8,512,435,485,460,454,48,143,124,20,128,460,50,6,133,-19,5,-1092,11
20:59.4,4.9,502,433,486,456,454,48,143,124,20,128,459,53,5,133,-19,5,-1088,11
20:59.4,4.9,485,433,490,454,449,48,143,124,20,128,461,57,12,133,-19,5,-1083,18
20:59.5,5,485,433,490,454,449,47,152,111,10,132,461,57,12,131,-41,0,-1091,12
20:59.5,5,485,433,490,454,449,37,203,80,7,156,461,57,12,141,-123,-14,-1060,-2
20:59.5,5,436,431,495,450,458,37,203,80,7,156,463,64,5,141,-123,-14,-1066,-9
20:59.5,5,370,412,501,414,457,37,203,80,7,156,456,89,0,141,-123,-14,-1023,-15
20:59.5,5,370,412,501,414,457,26,231,134,5,351,456,89,0,182,-97,-168,-789,-169
20:59.5,5,327,389,508,380,418,26,231,134,5,351,448,119,30,182,-97,-168,-708,-138
20:59.6,5.1,327,389,508,380,418,19,265,190,19,367,448,119,30,227,-75,-139,-633,-109
20:59.6,5.1,327,389,508,380,418,17,240,213,59,453,448,119,30,226,-27,-226,-508,-196
20:59.6,5.1,308,361,519,295,247,17,240,213,59,453,440,158,193,226,-27,-226,-243,-33
20:59.6,5.1,304,302,527,202,127,17,240,213,59,453,414,225,287,226,-27,-226,-5,61
20:59.7,5.2,316,219,532,156,113,17,240,213,59,453,375,313,262,226,-27,-226,94,36
20:59.7,5.2,316,219,532,156,113,19,219,255,109,514,375,313,262,237,36,-277,215,-14
20:59.7,5.2,316,219,532,156,113,21,257,288,135,534,375,313,262,272,31,-261,297,1
20:59.7,5.2,316,219,532,156,113,56,338,306,182,539,375,313,262,322,-32,-217,398,45
20:59.7,5.2,318,153,499,111,114,56,338,306,182,539,326,346,212,322,-32,-217,492,-5
20:59.8,5.3,204,94,430,112,115,56,338,306,182,539,262,336,147,322,-32,-217,554,-70
20:59.8,5.3,204,94,430,112,115,77,377,329,224,546,262,336,147,353,-48,-193,634,-46
20:59.8,5.3,204,94,430,112,115,93,406,374,290,547,262,336,147,390,-32,-157,738,-10
20:59.8,5.3,47,74,339,104,111,93,406,374,290,547,206,265,95,390,-32,-157,805,-61
20:59.9,5.4,84,67,228,85,112,93,406,374,290,547,147,161,35,390,-32,-157,882,-121
20:59.9,5.4,84,67,228,85,112,101,414,413,346,552,147,161,35,413,-1,-138,967,-103
20:59.9,5.4,100,63,220,66,118,101,414,413,346,552,141,157,23,413,-1,-138,986,-115
20:59.9,5.4,103,56,168,54,121,101,414,413,346,552,112,112,-9,413,-1,-138,1024,-147
21:00.0,5.5,103,56,168,54,121,104,385,453,396,554,112,112,-9,419,68,-135,1082,-144
21:00.0,5.5,106,45,139,47,118,104,385,453,396,554,92,94,-26,419,68,-135,1112,-161
21:00.0,5.5,106,45,139,47,118,107,390,489,419,546,92,94,-26,439,99,-106,1147,-132
21:00.0,5.5,106,45,139,47,118,117,443,489,423,534,92,94,-26,466,46,-68,1166,-94
21:00.0,5.5,106,30,141,46,105,117,443,489,423,534,85,111,-19,466,46,-68,1186,-87
21:00.1,5.6,106,30,141,46,105,207,501,485,422,506,85,111,-19,493,-16,-13,1184,-32
21:00.1,5.6,106,20,142,36,94,207,501,485,422,506,81,122,-13,493,-16,-13,1210,-26
21:00.2,5.7,106,17,142,33,80,207,501,485,422,506,79,125,0,493,-16,-13,1228,-13
21:00.2,5.7,106,14,143,20,90,207,501,485,422,506,78,129,-11,493,-16,-13,1232,-24
21:00.2,5.7,106,14,143,20,90,306,529,492,426,488,78,129,-11,510,-37,22,1236,11
21:00.2,5.7,106,14,143,20,90,349,549,507,431,463,78,129,-11,528,-42,65,1233,53
21:00.3,5.8,102,14,102,11,187,349,549,507,431,463,58,88,-129,528,-42,65,1166,-64
21:00.3,5.8,102,14,102,11,187,378,562,520,437,410,58,88,-129,541,-42,131,1132,2
21:00.3,5.8,102,14,102,11,187,402,581,534,439,327,58,88,-129,557,-47,230,1067,101
21:00.3,5.8,99,12,104,17,463,402,581,534,439,327,58,92,-405,557,-47,230,785,-174
21:00.3,5.8,99,12,104,17,463,438,594,550,433,204,58,92,-405,572,-44,368,671,-37
21:00.3,5.8,99,12,104,17,463,455,551,561,372,123,58,92,-405,556,10,433,513,28
21:00.4,5.9,126,110,119,131,505,455,551,561,372,123,114,9,-390,556,10,433,300,42
21:00.4,5.9,126,110,119,131,505,461,362,569,260,129,114,9,-390,465,207,336,104,-54
21:00.4,5.9,167,226,210,227,514,461,362,569,260,129,218,-16,-296,465,207,336,-104,40
21:00.4,5.9,167,226,210,227,514,469,169,549,116,123,218,-16,-296,359,380,236,-361,-60
21:00.4,5.9,214,253,307,265,525,469,169,549,116,123,280,54,-245,359,380,236,-472,-9
21:00.5,6,214,253,307,265,525,428,45,487,86,122,280,54,-245,266,442,144,-596,-101
21:00.5,6,244,252,351,275,538,428,45,487,86,122,301,99,-236,266,442,144,-640,-92
21:00.5,6,244,252,351,275,538,232,40,320,81,125,301,99,-236,180,280,55,-728,-181
21:00.5,6,244,252,351,275,538,60,61,210,77,127,301,99,-236,135,149,8,-775,-228
21:00.6,6.1,273,279,390,314,553,60,61,210,77,127,334,111,-218,135,149,8,-862,-210
21:00.6,6.1,334,332,443,369,543,60,61,210,77,127,387,111,-155,135,149,8,-960,-147
21:00.6,6.1,334,332,443,369,543,63,87,195,71,138,387,111,-155,141,108,3,-949,-152
21:00.6,6.1,334,332,443,369,543,61,106,153,55,139,387,111,-155,129,47,-9,-976,-165
21:00.7,6.2,363,384,471,402,533,61,106,153,55,139,427,87,-105,129,47,-9,-1039,-115
21:00.7,6.2,393,409,494,425,505,61,106,153,55,139,451,85,-53,129,47,-9,-1058,-63
21:00.7,6.2,393,409,494,425,505,59,115,107,41,143,451,85,-53,111,-8,-32,-1086,-85
21:00.7,6.2,422,428,512,446,443,59,115,107,41,143,470,84,27,111,-8,-32,-1064,-5
21:00.7,6.2,422,428,512,446,443,57,111,83,28,143,470,84,27,97,-28,-46,-1091,-19
21:00.8,6.3,461,450,540,465,358,57,111,83,28,143,495,90,137,97,-28,-46,-1050,91
21:00.8,6.3,461,450,540,465,358,57,114,69,19,140,495,90,137,91,-45,-48,-1067,88
21:00.8,6.3,493,461,575,468,272,57,114,69,19,140,518,114,246,91,-45,-48,-1007,197
21:00.9,6.4,519,479,597,459,160,57,114,69,19,140,538,118,378,91,-45,-48,-906,329
21:00.9,6.4,545,490,609,401,103,57,114,69,19,140,549,119,446,91,-45,-48,-803,398
21:00.9,6.4,545,490,609,401,103,55,118,57,8,136,549,119,446,87,-61,-48,-822,398
21:00.9,6.4,545,490,609,401,103,46,83,69,9,315,549,119,446,76,-14,-239,-653,207
21:00.9,6.4,545,490,609,401,103,48,83,131,3,541,549,119,446,107,48,-434,-402,12
21:00.9,6.4,565,421,604,265,116,48,83,131,3,541,512,183,396,107,48,-434,-242,-37
21:01.0,6.5,568,287,558,149,127,48,83,131,3,541,422,271,295,107,48,-434,-47,-138
21:01.0,6.5,568,287,558,149,127,27,267,215,22,563,422,271,295,241,-52,-322,127,-26
21:01.0,6.5,568,287,558,149,127,0,423,264,59,572,422,271,295,343,-159,-228,276,67
21:01.0,6.5,556,181,445,130,128,0,423,264,59,572,313,264,185,343,-159,-228,403,-43
21:01.0,6.5,556,181,445,130,128,48,467,263,78,585,313,264,185,365,-204,-220,457,-35
21:01.1,6.6,376,110,304,119,124,48,467,263,78,585,207,194,83,365,-204,-220,578,-137
21:01.1,6.6,94,90,179,108,122,48,467,263,78,585,134,89,12,365,-204,-220,663,-207
21:01.1,6.6,94,90,179,108,122,141,492,276,119,595,134,89,12,384,-216,-211,733,-198
21:01.2,6.7,121,72,154,105,134,141,492,276,119,595,113,82,-21,384,-216,-211,746,-232
21:01.2,6.7,121,72,154,105,134,243,520,306,154,600,113,82,-21,413,-214,-187,815,-208
21:01.2,6.7,130,67,136,78,138,243,520,306,154,600,101,69,-36,413,-214,-187,849,-223
21:01.2,6.7,130,67,136,78,138,325,531,318,194,598,101,69,-36,424,-213,-173,899,-210
21:01.2,6.7,130,67,136,78,138,364,547,340,232,585,101,69,-36,443,-207,-141,943,-178
21:01.2,6.7,133,55,134,62,134,364,547,340,232,585,94,79,-39,443,-207,-141,970,-181
21:01.3,6.8,133,55,134,62,134,399,560,365,269,550,94,79,-39,462,-195,-87,991,-127
21:01.3,6.8,125,43,137,51,130,399,560,365,269,550,90,94,-40,462,-195,-87,1010,-127
21:01.3,6.8,126,38,132,47,122,399,560,365,269,550,85,94,-37,462,-195,-87,1027,-124
21:01.3,6.8,126,38,132,47,122,429,577,400,294,504,85,94,-37,488,-177,-15,1032,-52
21:01.4,6.9,126,38,132,47,122,471,603,445,319,400,85,94,-37,524,-158,124,989,87
21:01.4,6.9,131,27,123,44,115,471,603,445,319,400,75,96,-40,524,-158,124,1009,84
21:01.4,6.9,131,27,123,44,115,504,621,480,334,263,75,96,-40,550,-141,287,913,247
21:01.4,6.9,111,29,113,34,133,504,621,480,334,263,71,84,-62,550,-141,287,909,225
21:01.5,7,111,29,113,34,133,529,631,528,274,130,71,84,-62,579,-103,449,745,387
21:01.5,7,111,29,113,34,133,541,614,518,124,131,71,84,-62,566,-96,435,583,373
21:01.5,7,105,49,94,22,502,541,614,518,124,131,71,45,-430,566,-96,435,225,4
21:01.5,7,92,31,97,57,590,541,614,518,124,131,64,66,-526,566,-96,435,110,-91
21:01.6,7.1,92,31,97,57,590,556,510,444,64,124,64,66,-526,477,-66,353,-46,-173
21:01.6,7.1,57,259,164,261,587,556,510,444,64,124,211,-95,-375,477,-66,353,-394,-22
21:01.6,7.1,57,259,164,261,587,513,354,216,57,125,211,-95,-375,285,-138,160,-592,-215
21:01.6,7.1,57,259,164,261,587,242,185,149,55,127,211,-95,-375,167,-36,40,-710,-335
21:01.7,7.2,102,295,223,297,592,242,185,149,55,127,259,-72,-333,167,-36,40,-799,-293
21:01.7,7.2,191,312,302,327,586,242,185,149,55,127,307,-10,-279,167,-36,40,-871,-239
21:01.7,7.2,191,312,302,327,586,115,116,123,50,142,307,-10,-279,119,7,-22,-908,-301
21:01.7,7.2,222,339,347,357,574,115,116,123,50,142,343,8,-231,119,7,-22,-962,-253
21:01.7,7.2,222,339,347,357,574,97,149,114,37,147,343,8,-231,131,-35,-15,-958,-246
21:01.7,7.2,266,374,413,389,568,97,149,114,37,147,393,39,-174,131,-35,-15,-1035,-190
21:01.8,7.3,266,374,413,389,568,89,146,81,25,149,393,39,-174,113,-65,-35,-1063,-210
21:01.8,7.3,325,389,447,406,561,89,146,81,25,149,418,58,-143,113,-65,-35,-1097,-178
21:01.8,7.3,325,389,447,406,561,82,147,60,18,149,418,58,-143,103,-87,-45,-1114,-188
21:01.9,7.4,365,401,481,421,521,82,147,60,18,149,441,80,-80,103,-87,-45,-1112,-125
21:01.9,7.4,400,424,505,441,462,82,147,60,18,149,464,81,2,103,-87,-45,-1097,-43
21:01.9,7.4,400,424,505,441,462,80,147,50,11,149,464,81,2,98,-97,-50,-1109,-48
21:01.9,7.4,432,441,534,448,384,80,147,50,11,149,487,93,103,98,-97,-50,-1061,53
21:01.9,7.4,432,441,534,448,384,80,148,40,8,145,487,93,103,94,-108,-51,-1072,52
21:02.0,7.5,432,441,534,448,384,81,152,33,3,133,487,93,103,92,-119,-40,-1091,63
21:02.0,7.5,469,436,565,410,267,81,152,33,3,133,500,129,233,92,-119,-40,-949,193
21:02.0,7.5,469,426,592,338,127,81,152,33,3,133,509,166,382,92,-119,-40,-745,341
21:02.1,7.6,441,349,573,215,147,81,152,33,3,133,461,224,314,92,-119,-40,-594,273
21:02.1,7.6,387,199,449,134,146,81,152,33,3,133,324,250,178,92,-119,-40,-375,137
21:02.2,7.7,156,118,295,130,143,81,152,33,3,133,206,177,63,92,-119,-40,-251,23
21:02.2,7.7,48,95,206,111,151,81,152,33,3,133,150,111,0,92,-119,-40,-184,-41
21:02.3,7.8,64,85,173,109,159,81,152,33,3,133,129,88,-30,92,-119,-40,-168,-70
21:02.3,7.8,73,81,130,88,158,81,152,33,3,133,105,49,-52,92,-119,-40,-123,-93
21:02.3,7.8,71,76,128,71,155,81,152,33,3,133,102,52,-53,92,-119,-40,-99,-93
21:02.4,7.9,71,76,128,71,155,74,122,30,0,481,102,52,-53,76,-92,-405,229,-458
21:02.4,7.9,71,76,128,71,155,69,172,199,9,620,102,52,-53,185,27,-434,486,-487
21:02.4,7.9,79,66,122,57,150,69,172,199,9,620,94,56,-56,185,27,-434,513,-490
21:02.4,7.9,79,66,122,57,150,13,336,297,130,623,94,56,-56,316,-39,-306,768,-362
21:02.4,7.9,79,66,122,57,150,0,380,332,181,619,94,56,-56,356,-48,-263,855,-319
21:02.4,7.9,79,66,122,57,150,1,408,366,261,590,94,56,-56,387,-42,-203,937,-259
21:02.4,7.9,79,66,122,57,150,6,408,406,331,569,94,56,-56,407,-2,-162,1006,-218
21:02.4,7.9,79,66,122,57,150,21,393,452,396,560,94,56,-56,422,59,-137,1077,-193
21:02.5,8,83,54,121,53,144,21,393,452,396,560,87,67,-56,422,59,-137,1094,-194
21:02.5,8,89,48,116,48,130,21,393,452,396,560,82,68,-48,422,59,-137,1118,-185
21:02.5,8,87,40,113,40,116,21,393,452,396,560,76,73,-39,422,59,-137,1146,-177
21:02.6,8.1,89,33,109,31,109,21,393,452,396,560,71,76,-38,422,59,-137,1167,-175
21:02.6,8.1,89,33,109,31,109,37,423,483,421,537,71,76,-38,453,60,-84,1200,-122
21:02.6,8.1,89,33,109,31,109,50,473,504,432,507,71,76,-38,488,31,-18,1216,-56
21:02.6,8.1,89,33,109,31,109,95,516,518,436,460,71,76,-38,517,2,57,1202,19
21:02.6,8.1,89,33,109,31,109,134,548,537,442,384,71,76,-38,542,-11,158,1157,120
21:02.6,8.1,89,33,109,31,109,208,580,550,448,320,71,76,-38,565,-30,245,1122,207
21:02.6,8.1,89,33,109,31,109,277,605,563,437,178,71,76,-38,584,-42,406,988,368
21:02.6,8.1,89,33,109,31,109,306,622,573,346,118,71,76,-38,597,-49,479,850,441
21:02.7,8.2,80,68,78,30,364,306,622,573,346,118,73,10,-291,597,-49,479,594,188
21:02.7,8.2,74,48,71,38,614,306,622,573,346,118,59,23,-554,597,-49,479,350,-75
21:02.7,8.2,74,48,71,38,614,371,612,558,203,120,59,23,-554,585,-54,465,196,-89
21:02.7,8.2,74,48,71,38,614,437,491,522,85,114,59,23,-554,506,31,392,-6,-162
21:02.7,8.2,65,244,71,224,609,437,491,522,85,114,157,-173,-451,506,31,392,-285,-59
21:02.8,8.3,122,299,169,288,614,437,491,522,85,114,234,-130,-380,506,31,392,-430,12
21:02.8,8.3,122,299,169,288,614,409,309,339,87,120,234,-130,-380,324,30,204,-605,-176
21:02.8,8.3,122,299,169,288,614,194,151,188,78,124,234,-130,-380,169,37,45,-764,-334
21:02.8,8.3,122,299,169,288,614,97,77,176,73,132,234,-130,-380,126,99,-5,-804,-385
21:02.8,8.3,201,305,214,308,619,97,77,176,73,132,259,-91,-359,126,99,-5,-855,-365
21:02.8,8.3,242,312,272,328,620,97,77,176,73,132,292,-40,-328,126,99,-5,-908,-333
21:02.9,8.4,242,312,272,328,620,79,113,139,64,152,292,-40,-328,126,26,-26,-898,-354
21:02.9,8.4,317,359,317,373,607,79,113,139,64,152,338,-42,-269,126,26,-26,-976,-295
21:02.9,8.4,353,404,367,423,585,79,113,139,64,152,385,-37,-199,126,26,-26,-1051,-225
21:03.0,8.5,353,404,367,423,585,73,123,109,52,156,385,-37,-199,116,-14,-40,-1069,-239
21:03.0,8.5,353,404,367,423,585,68,127,87,32,158,385,-37,-199,107,-40,-51,-1096,-250
21:03.0,8.5,386,425,409,453,539,68,127,87,32,158,417,-16,-122,107,-40,-51,-1112,-173
21:03.0,8.5,386,425,409,453,539,66,128,69,18,157,417,-16,-122,98,-59,-58,-1135,-180
21:03.0,8.5,410,441,451,468,458,66,128,69,18,157,446,10,-12,98,-59,-58,-1098,-70
21:03.1,8.6,410,441,451,468,458,64,130,59,13,157,446,10,-12,94,-71,-62,-1107,-74
21:03.1,8.6,424,458,483,474,393,64,130,59,13,157,470,25,77,94,-71,-62,-1073,15
21:03.1,8.6,424,458,483,474,393,62,130,43,10,154,470,25,77,86,-87,-67,-1087,10
21:03.2,8.7,424,458,483,474,393,61,128,37,6,142,470,25,77,82,-91,-59,-1107,18
21:03.2,8.7,438,461,513,467,336,61,128,37,6,142,487,52,151,82,-91,-59,-1059,91
21:03.2,8.7,474,470,546,442,189,61,128,37,6,142,508,76,319,82,-91,-59,-908,259
21:03.2,8.7,474,470,546,442,189,55,90,28,0,354,508,76,319,59,-62,-295,-726,24
21:03.2,8.7,497,488,563,383,121,55,90,28,0,354,525,75,404,59,-62,-295,-616,109
21:03.3,8.8,497,488,563,383,121,57,91,110,0,614,525,75,404,100,19,-513,-315,-109
21:03.3,8.8,509,455,541,275,120,57,91,110,0,614,498,86,378,100,19,-513,-178,-135
21:03.3,8.8,509,455,541,275,120,17,278,274,64,605,498,86,378,276,-4,-329,52,49
21:03.3,8.8,506,318,463,152,115,17,278,274,64,605,390,145,275,276,-4,-329,287,-53
21:03.3,8.8,506,318,463,152,115,0,364,326,140,591,390,145,275,345,-38,-246,418,29
21:03.4,8.9,403,202,257,140,113,0,364,326,140,591,229,55,116,345,-38,-246,593,-129
21:03.4,8.9,403,202,257,140,113,49,404,351,201,575,229,55,116,377,-53,-197,671,-81
21:03.4,8.9,84,120,168,127,111,49,404,351,201,575,144,48,33,377,-53,-197,771,-164
21:03.5,9,84,120,168,127,111,97,428,381,280,558,144,48,33,404,-47,-153,860,-120
21:03.5,9,42,98,144,112,155,97,428,381,280,558,121,46,-34,404,-47,-153,854,-187
21:03.5,9,42,98,144,112,155,122,441,422,334,544,121,46,-34,431,-19,-112,921,-146
21:03.5,9,54,91,137,104,158,122,441,422,334,544,114,46,-44,431,-19,-112,933,-156
21:03.5,9,54,91,137,104,158,153,462,450,377,529,114,46,-44,456,-12,-73,986,-117
21:03.5,9,62,83,128,82,158,153,462,450,377,529,105,45,-52,456,-12,-73,1016,-125
21:03.6,9.1,62,83,128,82,158,195,502,478,402,496,105,45,-52,490,-24,-6,1042,-58
21:03.6,9.1,69,80,121,57,151,195,502,478,402,496,100,41,-50,490,-24,-6,1079,-56
21:03.6,9.1,69,80,121,57,151,230,537,497,413,432,100,41,-50,517,-40,85,1053,34
21:03.6,9.1,67,74,117,49,146,230,537,497,413,432,95,43,-50,517,-40,85,1071,34
21:03.7,9.2,67,74,117,49,146,301,567,522,421,365,95,43,-50,544,-45,179,1040,129
21:03.7,9.2,65,64,112,44,134,301,567,522,421,365,88,48,-46,544,-45,179,1064,133
21:03.7,9.2,65,64,112,44,134,338,596,540,427,315,88,48,-46,568,-56,253,1044,207
21:03.7,9.2,71,57,111,41,123,338,596,540,427,315,84,54,-39,568,-56,253,1062,214
21:03.8,9.3,71,57,111,41,123,371,617,555,397,161,84,54,-39,586,-62,425,896,386
21:03.8,9.3,67,62,86,28,151,371,617,555,397,161,74,24,-77,586,-62,425,891,348
21:03.8,9.3,67,62,86,28,151,392,631,566,285,102,74,24,-77,598,-65,496,732,419
21:03.8,9.3,67,83,76,25,508,392,631,566,285,102,79,-7,-428,598,-65,496,373,68
21:03.8,9.3,67,83,76,25,508,458,614,541,126,107,79,-7,-428,577,-73,470,198,42
21:03.9,9.4,56,165,82,118,580,458,614,541,126,107,123,-83,-456,577,-73,470,-11,14
21:03.9,9.4,56,165,82,118,580,486,494,447,71,111,123,-83,-456,470,-47,359,-169,-97
21:03.9,9.4,68,265,202,251,593,486,494,447,71,111,233,-63,-359,470,-47,359,-425,0
21:03.9,9.4,68,265,202,251,593,405,342,244,79,119,233,-63,-359,293,-98,174,-586,-185
21:04.0,9.5,68,265,202,251,593,160,169,176,69,120,233,-63,-359,172,7,52,-716,-307
21:04.0,9.5,159,290,259,308,600,160,169,176,69,120,274,-31,-325,172,7,52,-821,-273
21:04.0,9.5,221,319,314,356,594,160,169,176,69,120,316,-5,-277,172,7,52,-905,-225
21:04.0,9.5,268,360,345,391,588,160,169,176,69,120,352,-15,-235,172,7,52,-970,-183
21:04.1,9.6,268,360,345,391,588,87,113,150,64,144,352,-15,-235,131,37,-12,-992,-248
21:04.1,9.6,268,360,345,391,588,80,132,127,54,149,352,-15,-235,129,-5,-19,-999,-255
21:04.1,9.6,328,393,394,422,573,80,132,127,54,149,393,1,-179,129,-5,-19,-1056,-199
21:04.1,9.6,328,393,394,422,573,77,135,97,35,153,393,1,-179,116,-38,-37,-1084,-216
21:04.2,9.7,362,415,431,457,535,77,135,97,35,153,423,16,-112,116,-38,-37,-1111,-149
21:04.2,9.7,362,415,431,457,535,67,144,68,20,153,423,16,-112,106,-76,-47,-1136,-159
21:04.2,9.7,362,415,431,457,535,65,152,60,13,151,423,16,-112,106,-92,-45,-1145,-157
21:04.2,9.7,389,436,464,473,471,65,152,60,13,151,450,28,-21,106,-92,-45,-1124,-66
21:04.2,9.7,412,450,487,484,399,65,152,60,13,151,468,37,69,106,-92,-45,-1081,24
21:04.3,9.8,412,450,487,484,399,61,155,47,13,148,468,37,69,101,-108,-47,-1089,22
21:04.3,9.8,434,456,511,478,315,61,155,47,13,148,483,55,168,101,-108,-47,-1014,121
21:04.3,9.8,434,456,511,478,315,62,154,38,8,143,483,55,168,96,-116,-47,-1029,121
21:04.3,9.8,463,471,543,463,185,62,154,38,8,143,507,72,322,96,-116,-47,-908,275
21:04.4,9.9,463,471,543,463,185,57,130,38,3,149,507,72,322,84,-92,-65,-919,257
21:04.4,9.9,498,481,563,414,108,57,130,38,3,149,522,82,414,84,-92,-65,-808,349
21:04.4,9.9,523,467,555,317,109,57,130,38,3,149,511,88,402,84,-92,-65,-701,337
21:04.4,9.9,523,467,555,317,109,57,93,66,0,536,511,88,402,79,-27,-456,-321,-54
21:04.5,10,523,467,555,317,109,45,141,176,2,614,511,88,402,158,35,-455,-162,-53
21:04.5,10,528,364,506,215,105,45,141,176,2,614,435,142,330,158,35,-455,19,-125
21:04.5,10,509,220,335,144,109,45,141,176,2,614,277,115,168,158,35,-455,244,-287
21:04.5,10,509,220,335,144,109,4,334,296,110,599,277,115,168,315,-38,-284,493,-115
21:04.5,10,509,220,335,144,109,0,402,325,154,606,277,115,168,363,-77,-242,593,-74
21:04.6,10.1,223,157,192,132,112,0,402,325,154,606,174,35,62,363,-77,-242,705,-180
21:04.6,10.1,223,157,192,132,112,64,447,347,204,590,174,35,62,397,-100,-193,772,-130
21:04.6,10.1,25,98,134,110,146,64,447,347,204,590,116,36,-30,397,-100,-193,819,-223
21:04.6,10.1,50,100,138,108,149,64,447,347,204,590,119,38,-30,397,-100,-193,815,-223
21:04.7,10.2,50,100,138,108,149,109,483,357,240,588,119,38,-30,420,-126,-168,872,-198
21:04.7,10.2,50,100,138,108,149,150,510,352,250,592,119,38,-30,431,-158,-161,897,-191
21:04.7,10.2,60,87,126,89,153,150,510,352,250,592,106,39,-46,431,-158,-161,924,-207
21:04.7,10.2,60,87,126,89,153,249,533,380,295,565,106,39,-46,456,-153,-108,968,-155
21:04.7,10.2,59,81,121,68,151,249,533,380,295,565,101,40,-50,456,-153,-108,996,-158
21:04.8,10.3,59,81,121,68,151,319,550,391,313,540,101,40,-50,470,-159,-69,1003,-119
21:04.8,10.3,59,72,120,52,144,319,550,391,313,540,96,48,-48,470,-159,-69,1031,-117
21:04.8,10.3,60,65,117,46,129,319,550,391,313,540,91,52,-38,470,-159,-69,1057,-107
21:04.8,10.3,60,65,117,46,129,373,566,426,330,483,91,52,-38,496,-140,13,1043,-25
21:04.9,10.4,62,56,116,43,114,373,566,426,330,483,86,60,-28,496,-140,13,1066,-15
21:04.9,10.4,61,62,101,36,140,373,566,426,330,483,81,39,-58,496,-140,13,1051,-45
21:05.0,10.5,61,62,101,36,140,420,595,459,357,376,81,39,-58,527,-136,151,1002,92
21:05.0,10.5,61,62,101,36,140,466,619,495,353,267,81,39,-58,557,-124,290,919,231
21:05.0,10.5,61,62,101,36,140,496,634,525,260,110,81,39,-58,579,-109,469,692,411
21:05.0,10.5,62,72,83,23,483,496,634,525,260,110,77,11,-405,579,-109,469,366,64
21:05.0,10.5,62,72,83,23,483,513,620,510,117,125,77,11,-405,565,-110,440,223,34
21:05.0,10.5,58,134,80,109,585,513,620,510,117,125,107,-54,-478,565,-110,440,6,-38
21:05.0,10.5,58,134,80,109,585,535,512,400,52,123,107,-54,-478,456,-112,333,-170,-145
21:05.1,10.6,58,134,80,109,585,456,356,176,64,128,107,-54,-478,266,-180,138,-343,-340
21:05.1,10.6,32,275,212,260,596,456,356,176,64,128,243,-63,-352,266,-180,138,-641,-214
21:05.1,10.6,139,307,284,305,601,456,356,176,64,128,295,-23,-305,266,-180,138,-743,-167
21:05.1,10.6,139,307,284,305,601,181,183,113,59,130,295,-23,-305,148,-70,18,-864,-287
21:05.2,10.7,203,354,328,359,593,181,183,113,59,130,341,-26,-252,148,-70,18,-956,-234
21:05.2,10.7,203,354,328,359,593,102,109,108,51,154,341,-26,-252,108,-1,-45,-979,-297
21:05.2,10.7,203,354,328,359,593,87,138,103,35,149,341,-26,-252,120,-35,-28,-988,-280
21:05.2,10.7,227,400,347,404,576,87,138,103,35,149,373,-53,-202,120,-35,-28,-1049,-231
21:05.3,10.8,244,431,381,443,556,87,138,103,35,149,406,-50,-150,120,-35,-28,-1100,-178
21:05.3,10.8,244,431,381,443,556,83,151,85,20,154,406,-50,-150,118,-66,-36,-1113,-186
21:05.3,10.8,244,431,381,443,556,80,161,65,15,155,406,-50,-150,113,-96,-42,-1122,-192
21:05.3,10.8,274,441,410,465,550,80,161,65,15,155,425,-31,-124,113,-96,-42,-1157,-166
21:05.3,10.8,319,453,443,486,499,80,161,65,15,155,448,-10,-51,113,-96,-42,-1150,-93
21:05.4,10.9,319,453,443,486,499,81,165,50,11,154,448,-10,-51,107,-115,-46,-1160,-97
21:05.4,10.9,319,453,443,486,499,79,166,40,8,151,448,-10,-51,103,-126,-48,-1171,-99
21:05.4,10.9,354,470,473,496,439,79,166,40,8,151,471,3,32,103,-126,-48,-1144,-15
21:05.5,11,389,473,495,500,376,79,166,40,8,151,484,22,108,103,-126,-48,-1098,60
21:05.5,11,389,473,495,500,376,76,167,32,4,143,484,22,108,99,-135,-43,-1113,64
21:05.5,11,389,473,495,500,376,70,161,30,1,131,484,22,108,95,-131,-35,-1132,72
21:05.5,11,421,496,521,503,303,70,161,30,1,131,508,25,205,95,-131,-35,-1087,170
21:05.5,11,451,515,544,482,155,70,161,30,1,131,529,29,374,95,-131,-35,-939,339
21:05.5,11,451,515,544,482,155,64,131,39,1,161,529,29,374,85,-92,-76,-919,298
21:05.6,11.1,451,515,544,482,155,67,103,104,0,559,529,29,374,103,1,-455,-504,-81
21:05.6,11.1,485,529,561,421,104,67,103,104,0,559,545,32,441,103,1,-455,-407,-14
21:05.6,11.1,522,506,548,324,104,67,103,104,0,559,527,42,423,103,1,-455,-292,-32
21:05.6,11.1,522,506,548,324,104,55,128,182,0,588,527,42,423,155,54,-433,-212,-10
21:05.7,11.2,526,399,496,234,106,55,128,182,0,588,447,97,341,155,54,-433,-44,-91
21:05.7,11.2,526,399,496,234,106,9,352,264,55,594,447,97,341,308,-88,-286,169,55
21:05.7,11.2,518,268,354,145,109,9,352,264,55,594,311,86,202,308,-88,-286,392,-84
21:05.8,11.3,355,185,183,139,106,9,352,264,55,594,184,-2,78,308,-88,-286,528,-208
21:05.8,11.3,355,185,183,139,106,38,425,277,88,614,184,-2,78,351,-148,-263,624,-185
21:05.8,11.3,355,185,183,139,106,96,457,283,120,619,184,-2,78,370,-174,-249,680,-171
21:05.8,11.3,71,117,139,121,104,96,457,283,120,619,128,22,24,370,-174,-249,756,-225
21:05.8,11.3,71,117,139,121,104,154,486,307,167,611,128,22,24,396,-179,-214,821,-190
21:05.8,11.3,37,106,137,107,150,154,486,307,167,611,121,31,-28,396,-179,-214,796,-243
21:05.9,11.4,55,92,121,99,148,154,486,307,167,611,106,29,-41,396,-179,-214,821,-256
21:05.9,11.4,55,92,121,99,148,233,509,328,229,607,106,29,-41,418,-181,-188,901,-230
21:05.9,11.4,55,92,121,99,148,291,526,358,281,594,106,29,-41,442,-168,-152,963,-193
21:05.9,11.4,66,79,115,78,145,291,526,358,281,594,97,36,-48,442,-168,-152,997,-200
21:06.0,11.5,66,79,115,78,145,321,542,382,304,561,97,36,-48,462,-160,-99,1007,-147
21:06.0,11.5,66,74,111,58,144,321,542,382,304,561,92,37,-51,462,-160,-99,1032,-150
21:06.0,11.5,65,67,110,52,138,321,542,382,304,561,88,43,-49,462,-160,-99,1048,-148
21:06.0,11.5,65,67,110,52,138,350,559,412,324,526,88,43,-49,485,-147,-40,1057,-90
21:06.0,11.5,65,62,107,45,127,350,559,412,324,526,84,45,-42,485,-147,-40,1079,-83
21:06.1,11.6,65,62,107,45,127,386,581,437,339,481,84,45,-42,509,-144,28,1072,-14
21:06.1,11.6,65,62,107,45,127,437,601,466,362,402,84,45,-42,533,-135,131,1041,89
21:06.1,11.6,63,51,105,41,111,437,601,466,362,402,78,54,-33,533,-135,131,1067,98
21:06.2,11.7,71,53,87,33,100,437,601,466,362,402,70,34,-30,533,-135,131,1094,101
21:06.2,11.7,71,53,87,33,100,476,622,492,367,303,70,34,-30,557,-130,254,1024,224
21:06.2,11.7,71,53,87,33,100,495,634,527,309,117,70,34,-30,580,-107,463,803,433
21:06.2,11.7,64,56,72,17,446,495,634,527,309,117,64,16,-382,580,-107,463,479,81
21:06.3,11.8,64,56,72,17,446,515,628,526,159,132,64,16,-382,577,-102,445,341,63
21:06.3,11.8,64,56,72,17,446,522,554,446,68,129,64,16,-382,500,-108,371,170,-11
21:06.3,11.8,65,47,60,19,609,522,554,446,68,129,53,13,-555,500,-108,371,15,-184
21:06.3,11.8,21,225,63,205,606,522,554,446,68,129,144,-162,-462,500,-108,371,-258,-91
21:06.3,11.8,21,225,63,205,606,501,454,241,66,130,144,-162,-462,347,-213,217,-411,-244
21:06.4,11.9,23,294,105,311,606,501,454,241,66,130,199,-189,-406,347,-213,217,-573,-189
21:06.4,11.9,51,335,168,373,599,501,454,241,66,130,251,-167,-347,347,-213,217,-680,-130
21:06.4,11.9,51,335,168,373,599,265,331,145,62,135,251,-167,-347,238,-186,103,-788,-244
21:06.4,11.9,51,335,168,373,599,111,154,159,54,130,251,-167,-347,156,5,26,-883,-321
21:06.4,11.9,98,386,208,409,583,111,154,159,54,130,297,-178,-286,156,5,26,-948,-259
21:06.5,12,98,386,208,409,583,88,151,123,46,150,297,-178,-286,137,-28,-13,-956,-299
21:06.5,12,122,419,263,450,569,88,151,123,46,150,341,-156,-228,137,-28,-13,-1027,-241
21:06.5,12,122,419,263,450,569,85,157,101,29,153,341,-156,-228,129,-56,-24,-1049,-252
21:06.5,12,140,438,293,472,564,85,157,101,29,153,365,-145,-198,129,-56,-24,-1090,-222
21:06.6,12.1,140,438,293,472,564,82,158,81,19,154,365,-145,-198,119,-77,-34,-1109,-233
21:06.6,12.1,151,440,331,477,565,82,158,81,19,154,385,-109,-179,119,-77,-34,-1135,-214
21:06.6,12.1,175,446,382,486,536,82,158,81,19,154,414,-64,-122,119,-77,-34,-1143,-156
21:06.6,12.1,175,446,382,486,536,82,161,62,14,153,414,-64,-122,111,-99,-41,-1157,-163
21:06.7,12.2,175,446,382,486,536,80,167,49,11,149,414,-64,-122,108,-118,-41,-1168,-163
21:06.7,12.2,204,452,434,491,499,80,167,49,11,149,443,-18,-56,108,-118,-41,-1165,-97
21:06.7,12.2,204,452,434,491,499,79,169,43,4,141,443,-18,-56,106,-126,-35,-1182,-91
21:06.7,12.2,223,464,463,501,450,79,169,43,4,141,463,-1,13,106,-126,-35,-1163,-21
21:06.7,12.2,223,464,463,501,450,77,168,37,3,129,463,-1,13,102,-131,-26,-1180,-13
21:06.8,12.3,265,474,487,502,356,77,168,37,3,129,480,13,124,102,-131,-26,-1104,98
21:06.8,12.3,265,474,487,502,356,74,159,35,1,123,480,13,124,97,-124,-26,-1117,98
21:06.8,12.3,328,494,509,484,231,74,159,35,1,123,501,15,270,97,-124,-26,-995,244
21:06.9,12.4,328,494,509,484,231,66,113,48,0,255,501,15,270,80,-65,-174,-881,96
21:06.9,12.4,375,505,525,427,123,66,113,48,0,255,515,20,392,80,-65,-174,-729,217
21:06.9,12.4,375,505,525,427,123,73,112,94,0,612,515,20,392,103,-18,-509,-350,-117
21:06.9,12.4,412,478,527,331,123,73,112,94,0,612,502,49,379,103,-18,-509,-241,-129
21:06.9,12.4,412,478,527,331,123,63,147,189,0,618,502,49,379,168,42,-450,-170,-70
21:07.0,12.5,423,365,483,211,118,63,147,189,0,618,424,118,306,168,42,-450,33,-144
21:07.0,12.5,423,365,483,211,118,12,321,269,62,603,424,118,306,295,-52,-308,207,-2
21:07.0,12.5,425,230,344,145,121,12,321,269,62,603,287,114,166,295,-52,-308,407,-142
21:07.0,12.5,266,174,174,145,126,12,321,269,62,603,174,0,48,295,-52,-308,515,-260
21:07.1,12.6,266,174,174,145,126,3,381,299,130,601,174,0,48,340,-82,-261,626,-213
21:07.1,12.6,48,115,133,120,122,3,381,299,130,601,124,18,2,340,-82,-261,705,-259
21:07.1,12.6,48,115,133,120,122,49,414,338,182,585,124,18,2,376,-76,-209,777,-207
21:07.1,12.6,48,115,133,120,122,90,461,366,245,584,124,18,2,413,-95,-170,876,-168
21:07.2,12.7,21,94,129,106,152,90,461,366,245,584,111,35,-40,413,-95,-170,873,-211
21:07.2,12.7,42,86,120,98,150,90,461,366,245,584,103,34,-47,413,-95,-170,891,-217
21:07.2,12.7,51,75,112,79,146,90,461,366,245,584,93,37,-52,413,-95,-170,924,-223
21:07.2,12.7,51,75,112,79,146,144,488,397,304,568,93,37,-52,442,-91,-125,996,-178
21:07.3,12.8,51,75,112,79,146,193,508,435,345,533,93,37,-52,471,-73,-61,1031,-114
21:07.3,12.8,57,72,111,57,146,193,508,435,345,533,91,39,-54,471,-73,-61,1055,-116
21:07.3,12.8,57,72,111,57,146,230,532,451,362,498,91,39,-54,491,-81,-6,1057,-61
21:07.3,12.8,57,72,111,57,146,269,554,470,376,450,91,39,-54,512,-84,62,1043,7
21:07.3,12.8,57,69,106,48,140,269,554,470,376,450,87,37,-52,512,-84,62,1062,9
21:07.4,12.9,59,62,100,43,128,269,554,470,376,450,81,38,-47,512,-84,62,1086,15
21:07.4,12.9,59,62,100,43,128,309,572,485,402,403,81,38,-47,528,-87,125,1081,78
21:07.4,12.9,58,49,87,37,112,309,572,485,402,403,68,38,-44,528,-87,125,1116,81
21:07.4,12.9,58,49,87,37,112,355,596,518,420,346,68,38,-44,557,-78,211,1106,167
21:07.4,12.9,58,49,87,37,112,387,616,541,426,262,68,38,-44,578,-75,316,1049,272
21:07.4,12.9,59,55,73,32,113,387,616,541,426,262,64,18,-49,578,-75,316,1057,267
21:07.5,13,59,55,73,32,113,406,628,554,364,104,64,18,-49,591,-74,487,850,438
21:07.5,13,52,56,71,28,265,406,628,554,364,104,63,15,-201,591,-74,487,702,285
21:07.5,13,52,56,71,28,265,440,628,553,259,112,63,15,-201,590,-75,478,605,277
21:07.5,13,54,76,57,26,544,440,628,553,259,112,66,-19,-477,590,-75,478,325,1
21:07.6,13.1,54,76,57,26,544,482,542,528,104,112,66,-19,-477,535,-14,423,114,-54
21:07.6,13.1,17,164,150,131,570,482,542,528,104,112,157,-14,-413,535,-14,423,-107,10
21:07.6,13.1,17,164,150,131,570,502,418,401,70,118,157,-14,-413,409,-17,291,-260,-121
21:07.6,13.1,129,239,242,247,583,502,418,401,70,118,240,3,-342,409,-17,291,-473,-51
21:07.7,13.2,129,239,242,247,583,376,273,201,73,126,240,3,-342,237,-72,111,-634,-231
21:07.7,13.2,129,239,242,247,583,158,121,174,67,123,240,3,-342,147,53,24,-733,-318
21:07.7,13.2,227,277,300,310,587,158,121,174,67,123,288,23,-298,147,53,24,-848,-274
21:07.7,13.2,294,311,331,355,570,158,121,174,67,123,321,20,-249,147,53,24,-908,-224
21:07.8,13.3,350,360,360,388,550,158,121,174,67,123,360,0,-190,147,53,24,-960,-165
21:07.8,13.3,350,360,360,388,550,100,95,130,58,147,360,0,-190,112,35,-34,-980,-224
21:07.8,13.3,350,360,360,388,550,88,131,114,42,152,360,0,-190,122,-17,-29,-981,-219
21:07.8,13.3,379,399,400,429,522,88,131,114,42,152,399,1,-122,122,-17,-29,-1034,-152
21:07.8,13.3,379,399,400,429,522,87,136,90,26,154,399,1,-122,113,-46,-41,-1057,-163
21:07.9,13.4,397,419,427,457,481,87,136,90,26,154,423,8,-58,113,-46,-41,-1068,-99
21:07.9,13.4,397,419,427,457,481,84,142,79,18,154,423,8,-58,110,-63,-43,-1078,-101
21:07.9,13.4,414,436,455,470,423,84,142,79,18,154,445,19,22,110,-63,-43,-1056,-21
21:08.0,13.5,414,436,455,470,423,81,148,62,13,151,445,19,22,105,-86,-46,-1069,-23
21:08.0,13.5,434,456,479,476,359,81,148,62,13,151,467,23,108,105,-86,-46,-1033,62
21:08.0,13.5,434,456,479,476,359,79,151,60,7,144,467,23,108,105,-91,-38,-1046,70
21:08.0,13.5,454,472,498,482,299,79,151,60,7,144,485,26,186,105,-91,-38,-1009,147
21:08.0,13.5,454,472,498,482,299,75,151,48,5,130,485,26,186,99,-103,-30,-1031,155
21:08.1,13.6,477,482,520,475,184,75,151,48,5,130,501,38,317,99,-103,-30,-925,286
21:08.1,13.6,477,482,520,475,184,69,151,37,3,125,501,38,317,94,-114,-31,-938,286
21:08.1,13.6,506,498,541,444,89,69,151,37,3,125,519,43,430,94,-114,-31,-830,399
21:08.1,13.6,506,498,541,444,89,64,114,44,0,370,519,43,430,79,-70,-291,-603,139
21:08.1,13.6,516,502,558,377,77,64,114,44,0,370,530,56,453,79,-70,-291,-535,162
21:08.2,13.7,514,462,537,281,65,64,114,44,0,370,499,75,434,79,-70,-291,-396,143
21:08.2,13.7,514,462,537,281,65,62,118,123,0,605,499,75,434,120,5,-484,-120,-50
21:08.2,13.7,512,349,452,179,74,62,118,123,0,605,400,103,326,120,5,-484,72,-158
21:08.2,13.7,512,349,452,179,74,24,291,247,39,590,400,103,326,269,-44,-321,244,5
21:08.2,13.7,512,349,452,179,74,0,394,282,87,600,400,103,326,338,-112,-262,371,64
21:08.3,13.8,456,210,242,138,89,0,394,282,87,600,226,32,137,338,-112,-262,572,-125
21:08.3,13.8,456,210,242,138,89,4,433,316,162,599,226,32,137,374,-117,-224,682,-87
21:08.3,13.8,172,154,158,121,94,4,433,316,162,599,156,4,62,374,-117,-224,764,-162
21:08.4,13.9,172,154,158,121,94,41,466,357,239,594,156,4,62,411,-109,-182,873,-120
21:08.4,13.9,23,92,127,107,117,41,466,357,239,594,109,35,-7,411,-109,-182,911,-190
21:08.4,13.9,48,90,134,100,125,41,466,357,239,594,112,44,-13,411,-109,-182,907,-195
21:08.4,13.9,48,90,134,100,125,87,498,368,271,598,112,44,-13,433,-130,-165,965,-178
21:08.5,14,48,90,134,100,125,130,516,384,304,587,112,44,-13,450,-132,-137,1004,-150
21:08.5,14,56,79,124,80,125,130,516,384,304,587,101,45,-23,450,-132,-137,1034,-160
21:08.5,14,62,70,120,59,125,130,516,384,304,587,95,50,-30,450,-132,-137,1062,-167
21:08.5,14,62,70,120,59,125,166,526,407,328,564,95,50,-30,466,-119,-97,1079,-127
21:08.5,14,64,70,122,49,121,166,526,407,328,564,96,52,-25,466,-119,-97,1092,-122
21:08.6,14.1,64,70,122,49,121,205,542,424,349,541,96,52,-25,483,-118,-58,1107,-83
21:08.6,14.1,64,70,122,49,121,249,555,451,374,513,96,52,-25,503,-104,-10,1124,-35
21:08.6,14.1,64,60,126,49,112,249,555,451,374,513,93,66,-19,503,-104,-10,1136,-29
21:08.6,14.1,64,60,126,49,112,292,571,476,410,480,93,66,-19,523,-95,43,1159,24
21:08.6,14.1,63,51,130,41,98,292,571,476,410,480,90,79,-7,523,-95,43,1184,36
21:08.7,14.2,63,51,130,41,98,331,592,506,430,406,90,79,-7,549,-86,143,1155,135
21:08.7,14.2,65,47,134,35,85,331,592,506,430,406,90,87,5,549,-86,143,1174,148
21:08.7,14.2,65,47,134,35,85,369,612,535,438,334,90,87,5,573,-77,239,1135,245
21:08.7,14.2,67,44,139,24,83,369,612,535,438,334,91,95,8,573,-77,239,1147,248
21:08.8,14.3,66,28,101,17,180,369,612,535,438,334,64,73,-115,573,-77,239,1084,124
21:08.8,14.3,66,28,101,17,180,403,626,554,424,180,64,73,-115,590,-72,410,932,294
21:08.8,14.3,66,28,101,17,180,440,623,569,318,125,64,73,-115,596,-54,471,777,355
21:08.8,14.3,62,62,84,9,513,440,623,569,318,125,73,22,-440,596,-54,471,444,31
21:08.9,14.4,11,160,178,137,530,440,623,569,318,125,169,18,-361,596,-54,471,203,110
21:08.9,14.4,11,160,178,137,530,476,583,545,133,130,169,18,-361,564,-38,434,-9,73
21:08.9,14.4,11,160,178,137,530,498,471,442,75,127,169,18,-361,456,-29,329,-177,-31
21:08.9,14.4,6,243,217,251,547,498,471,442,75,127,230,-26,-317,456,-29,329,-369,12
21:08.9,14.4,6,243,217,251,547,435,340,242,80,133,230,-26,-317,291,-98,158,-524,-159
21:09.0,14.5,31,263,289,284,574,435,340,242,80,133,276,26,-298,291,-98,158,-630,-140
21:09.0,14.5,89,268,333,304,590,435,340,242,80,133,300,65,-289,291,-98,158,-690,-131
21:09.0,14.5,89,268,333,304,590,206,200,172,69,137,300,65,-289,186,-28,49,-802,-240
21:09.1,14.6,89,268,333,304,590,97,101,176,63,139,300,65,-289,138,75,0,-854,-290
21:09.1,14.6,175,279,366,323,599,97,101,176,63,139,322,87,-276,138,75,0,-904,-277
21:09.1,14.6,175,279,366,323,599,91,135,134,54,156,322,87,-276,134,-1,-21,-900,-298
21:09.1,14.6,243,308,390,366,602,91,135,134,54,156,349,82,-253,134,-1,-21,-972,-274
21:09.2,14.7,243,308,390,366,602,86,141,114,34,159,349,82,-253,127,-27,-31,-996,-284
21:09.2,14.7,295,324,407,377,597,86,141,114,34,159,365,83,-231,127,-27,-31,-1019,-263
21:09.2,14.7,295,324,407,377,597,82,133,84,21,159,365,83,-231,108,-49,-50,-1051,-282
21:09.2,14.7,359,329,429,386,580,82,133,84,21,159,379,100,-201,108,-49,-50,-1056,-251
21:09.2,14.7,359,329,429,386,580,80,141,66,16,158,379,100,-201,103,-75,-54,-1067,-255
21:09.3,14.8,409,355,448,397,550,80,141,66,16,158,401,93,-148,103,-75,-54,-1071,-203
21:09.3,14.8,409,355,448,397,550,78,141,62,13,155,401,93,-148,101,-79,-53,-1079,-202
21:09.3,14.8,437,376,479,407,496,78,141,62,13,155,427,103,-68,101,-79,-53,-1061,-122
21:09.3,14.8,462,378,502,415,419,78,141,62,13,155,440,124,21,101,-79,-53,-1004,-32
21:09.3,14.8,462,378,502,415,419,78,143,61,7,150,440,124,21,102,-82,-48,-1015,-27
21:09.4,14.9,478,375,526,394,311,78,143,61,7,150,450,151,139,102,-82,-48,-896,91
21:09.4,14.9,444,384,533,298,132,78,143,61,7,150,458,149,326,102,-82,-48,-629,278
21:09.5,15,384,293,504,180,131,78,143,61,7,150,398,211,267,102,-82,-48,-450,219
21:09.5,15,321,193,310,130,134,78,143,61,7,150,251,117,117,102,-82,-48,-256,69
21:09.5,15,76,129,171,120,130,78,143,61,7,150,150,42,20,102,-82,-48,-141,-28
21:09.6,15.1,17,88,138,111,134,78,143,61,7,150,113,50,-21,102,-82,-48,-99,-69
21:09.6,15.1,17,88,138,111,134,73,114,110,0,462,113,50,-21,112,-4,-350,216,-371
21:09.6,15.1,17,88,138,111,134,25,264,244,43,520,113,50,-21,254,-20,-266,459,-287
21:09.6,15.1,17,88,138,111,134,76,361,298,122,528,113,50,-21,329,-63,-198,621,-219
21:09.6,15.1,17,88,138,111,134,109,409,328,179,518,113,50,-21,368,-81,-149,707,-170
21:09.6,15.1,17,88,138,111,134,128,438,381,266,505,113,50,-21,409,-57,-95,822,-116
21:09.7,15.2,38,76,132,102,143,128,438,381,266,505,104,56,-39,409,-57,-95,831,-134
21:09.7,15.2,38,76,132,102,143,142,455,432,333,485,104,56,-39,443,-23,-41,912,-80
21:09.7,15.2,38,76,132,102,143,167,464,461,391,478,104,56,-39,462,-3,-15,982,-54
21:09.7,15.2,38,76,132,102,143,196,495,477,406,461,104,56,-39,486,-18,25,1004,-14
21:09.7,15.2,43,73,123,79,137,196,495,477,406,461,98,50,-39,486,-18,25,1039,-14
21:09.7,15.2,54,67,114,60,130,196,495,477,406,461,90,47,-39,486,-18,25,1072,-14
21:09.8,15.3,54,67,114,60,130,218,515,494,414,429,90,47,-39,504,-21,75,1067,36
21:09.8,15.3,58,63,112,54,117,218,515,494,414,429,87,49,-29,504,-21,75,1089,46
21:09.8,15.3,58,63,112,54,117,247,537,512,420,380,87,49,-29,524,-25,144,1066,115
21:09.8,15.3,55,53,112,52,108,247,537,512,420,380,82,59,-25,524,-25,144,1082,119
21:09.9,15.4,55,53,112,52,108,290,552,528,428,354,82,59,-25,540,-24,186,1079,160
21:09.9,15.4,55,53,112,52,108,331,569,543,438,337,82,59,-25,556,-26,219,1088,193
21:09.9,15.4,58,44,105,41,90,331,569,543,438,337,74,61,-15,556,-26,219,1125,203
21:09.9,15.4,62,44,89,34,81,331,569,543,438,337,66,45,-14,556,-26,219,1149,204
21:09.9,15.4,62,44,89,34,81,363,588,556,444,291,66,45,-14,572,-32,281,1125,266
21:10.0,15.5,51,45,75,23,92,363,588,556,444,291,60,30,-32,572,-32,281,1132,249
21:10.0,15.5,51,45,75,23,92,392,605,565,439,206,60,30,-32,585,-40,379,1055,347
21:10.0,15.5,51,45,75,23,92,420,618,571,392,76,60,30,-32,594,-47,518,887,486
21:10.0,15.5,56,61,68,24,328,420,618,571,392,76,64,7,-263,594,-47,518,646,255
21:10.1,15.6,56,61,68,24,328,440,622,566,285,86,64,7,-263,594,-56,508,548,244
21:10.1,15.6,55,78,57,24,512,440,622,566,285,86,67,-21,-444,594,-56,508,361,63
21:10.1,15.6,76,151,90,108,548,440,622,566,285,86,120,-61,-427,594,-56,508,188,80
21:10.1,15.6,76,151,90,108,548,485,554,544,116,84,120,-61,-427,549,-10,465,-27,37
21:10.2,15.7,191,224,210,191,572,485,554,544,116,84,217,-14,-355,549,-10,465,-231,110
21:10.2,15.7,191,224,210,191,572,498,424,467,81,91,217,-14,-355,445,43,354,-362,0
21:10.2,15.7,191,224,210,191,572,414,279,294,81,101,217,-14,-355,286,15,185,-511,-169
21:10.2,15.7,289,255,288,260,584,414,279,294,81,101,271,33,-312,286,15,185,-647,-127
21:10.2,15.7,289,255,288,260,584,204,153,193,73,112,271,33,-312,173,40,61,-757,-251
21:10.2,15.7,383,283,319,309,589,204,153,193,73,112,301,36,-288,173,40,61,-841,-227
21:10.3,15.8,383,283,319,309,589,92,98,177,64,129,301,36,-288,137,79,8,-868,-279
21:10.3,15.8,420,310,341,348,583,92,98,177,64,129,325,31,-257,137,79,8,-926,-249
21:10.3,15.8,445,354,385,374,573,92,98,177,64,129,369,31,-203,137,79,8,-986,-195
21:10.3,15.8,445,354,385,374,573,95,122,142,59,138,369,31,-203,132,20,-6,-987,-209
21:10.4,15.9,445,354,385,374,573,92,142,110,41,140,369,31,-203,126,-32,-14,-1009,-217
21:10.4,15.9,460,384,414,389,554,92,142,110,41,140,399,30,-155,126,-32,-14,-1035,-169
21:10.4,15.9,460,384,414,389,554,86,143,85,26,142,399,30,-155,114,-58,-28,-1060,-183
21:10.4,15.9,474,399,435,404,519,86,143,85,26,142,417,36,-102,114,-58,-28,-1058,-130
21:10.5,16,474,399,435,404,519,84,149,73,18,141,417,36,-102,111,-76,-30,-1070,-132
21:10.5,16,488,416,466,419,448,84,149,73,18,141,441,50,-7,111,-76,-30,-1038,-37
21:10.5,16,488,416,466,419,448,80,154,73,14,134,441,50,-7,113,-81,-20,-1046,-27
21:10.5,16,501,432,484,427,383,80,154,73,14,134,458,52,75,113,-81,-20,-1006,54
21:10.6,16.1,517,431,507,426,333,80,154,73,14,134,469,76,136,113,-81,-20,-966,115
21:10.6,16.1,517,431,507,426,333,79,142,72,7,149,469,76,136,107,-70,-42,-965,94
21:10.6,16.1,518,429,533,404,197,79,142,72,7,149,481,104,284,107,-70,-42,-819,242
21:10.6,16.1,518,429,533,404,197,77,126,86,0,403,481,104,284,106,-40,-297,-573,-13
21:10.7,16.2,518,429,533,404,197,65,172,183,0,506,481,104,284,177,11,-328,-398,-44
21:10.7,16.2,527,434,545,355,101,65,172,183,0,506,489,111,388,177,11,-328,-262,60
21:10.7,16.2,527,434,545,355,101,9,320,269,67,511,489,111,388,294,-51,-216,-73,172
21:10.7,16.2,528,401,523,236,95,9,320,269,67,511,462,122,367,294,-51,-216,79,150
21:10.8,16.3,501,279,424,146,98,9,320,269,67,511,351,145,253,294,-51,-216,277,37
21:10.8,16.3,501,279,424,146,98,54,411,313,145,485,351,145,253,362,-98,-123,396,130
21:10.8,16.3,501,279,424,146,98,125,469,354,206,465,351,145,253,411,-115,-53,487,200
21:10.8,16.3,409,190,263,124,103,125,469,354,206,465,226,73,123,411,-115,-53,629,70
21:10.8,16.3,409,190,263,124,103,197,500,390,278,444,226,73,123,445,-110,1,713,124
21:10.8,16.3,159,125,178,116,105,197,500,390,278,444,151,53,46,445,-110,1,794,47
21:10.9,16.4,60,88,135,104,122,197,500,390,278,444,111,47,-10,445,-110,1,829,-9
21:10.9,16.4,60,88,135,104,122,262,519,431,336,446,111,47,-10,475,-88,29,919,18
21:10.9,16.4,68,74,136,93,133,262,519,431,336,446,105,62,-28,475,-88,29,926,1
21:10.9,16.4,68,74,136,93,133,299,534,455,378,444,105,62,-28,494,-79,50,985,22
21:11.0,16.5,72,73,130,72,134,299,534,455,378,444,101,57,-32,494,-79,50,1009,18
21:11.0,16.5,72,73,130,72,134,331,546,470,401,420,101,57,-32,508,-76,88,1021,55
21:11.0,16.5,72,73,130,72,134,351,556,486,410,368,101,57,-32,521,-70,153,991,120
21:11.0,16.5,72,68,128,59,131,351,556,486,410,368,98,60,-33,521,-70,153,1011,120
21:11.1,16.6,72,68,128,59,131,369,566,508,418,328,98,60,-33,537,-58,209,995,176
21:11.1,16.6,69,62,123,51,120,369,566,508,418,328,92,61,-27,537,-58,209,1019,181
21:11.1,16.6,81,56,120,45,114,369,566,508,418,328,88,64,-26,537,-58,209,1036,183
21:11.1,16.6,81,56,120,45,114,389,583,528,429,310,88,64,-26,555,-55,245,1047,219
21:11.2,16.7,92,51,115,38,99,389,583,528,429,310,83,64,-16,555,-55,245,1074,229
21:11.2,16.7,92,51,115,38,99,408,598,543,437,278,83,64,-16,570,-55,292,1065,276
21:11.2,16.7,92,38,108,31,87,408,598,543,437,278,73,70,-14,570,-55,292,1094,278
21:11.2,16.7,92,38,108,31,87,429,612,554,441,241,73,70,-14,583,-58,342,1074,328
21:11.3,16.8,92,38,108,31,87,451,622,563,435,150,73,70,-14,592,-59,442,986,428
21:11.3,16.8,95,38,90,22,83,451,622,563,435,150,64,52,-19,592,-59,442,1008,423
21:11.3,16.8,95,38,90,22,83,476,628,572,373,56,64,52,-19,600,-56,544,860,525
21:11.3,16.8,65,58,72,23,311,476,628,572,373,56,65,14,-246,600,-56,544,630,298
21:11.3,16.8,65,55,58,22,553,476,628,572,373,56,56,3,-496,600,-56,544,397,47
21:11.4,16.9,65,55,58,22,553,506,625,564,267,67,56,3,-496,594,-61,527,297,31
21:11.4,16.9,83,169,63,138,574,506,625,564,267,67,116,-106,-458,594,-61,527,100,69
21:11.4,16.9,83,169,63,138,574,520,549,531,103,64,116,-106,-458,540,-18,476,-121,18
21:11.4,16.9,83,169,63,138,574,517,459,418,83,69,116,-106,-458,438,-41,369,-237,-88
21:11.5,17,189,235,150,202,590,517,459,418,83,69,192,-85,-397,438,-41,369,-394,-28
21:11.5,17,189,235,150,202,590,418,360,250,83,78,192,-85,-397,305,-110,227,-518,-170
21:11.5,17,256,252,203,255,597,418,360,250,83,78,227,-49,-369,305,-110,227,-613,-142
21:11.5,17,312,277,258,313,593,418,360,250,83,78,267,-19,-325,305,-110,227,-707,-98
21:11.5,17,312,277,258,313,593,191,213,185,68,92,267,-19,-325,199,-28,107,-814,-218
21:11.6,17.1,312,277,258,313,593,102,135,171,63,102,267,-19,-325,153,36,51,-855,-274
21:11.6,17.1,372,327,322,363,584,102,135,171,63,102,324,-5,-259,153,36,51,-953,-208
21:11.6,17.1,372,327,322,363,584,104,153,137,53,126,324,-5,-259,145,-16,19,-947,-240
21:11.6,17.1,397,381,359,394,572,104,153,137,53,126,370,-22,-202,145,-16,19,-1012,-183
21:11.7,17.2,397,381,359,394,572,90,160,108,36,130,370,-22,-202,134,-52,4,-1036,-198
21:11.7,17.2,421,406,404,425,547,90,160,108,36,130,405,-2,-142,134,-52,4,-1077,-138
21:11.7,17.2,440,418,430,438,512,90,160,108,36,130,424,12,-88,134,-52,4,-1074,-84
21:11.7,17.2,440,418,430,438,512,88,168,86,22,133,424,12,-88,127,-82,-6,-1092,-94
21:11.8,17.3,440,418,430,438,512,86,169,69,17,125,424,12,-88,119,-100,-6,-1113,-94
21:11.8,17.3,453,425,450,445,471,86,169,69,17,125,437,25,-33,119,-100,-6,-1092,-39
21:11.8,17.3,467,432,471,459,427,86,169,69,17,125,451,39,24,119,-100,-6,-1076,18
21:11.8,17.3,467,432,471,459,427,82,170,66,13,121,451,39,24,118,-104,-3,-1085,21
21:11.9,17.4,467,432,471,459,427,82,172,58,7,122,451,39,24,115,-114,-7,-1093,17
21:11.9,17.4,482,437,486,470,376,82,172,58,7,122,461,49,85,115,-114,-7,-1063,78
21:11.9,17.4,497,446,506,473,328,82,172,58,7,122,476,60,148,115,-114,-7,-1033,141
21:11.9,17.4,497,446,506,473,328,80,171,52,7,121,476,60,148,111,-119,-9,-1037,138
21:11.9,17.4,497,446,506,473,328,78,142,64,0,224,476,60,148,103,-78,-121,-950,27
21:11.9,17.4,515,453,532,452,206,78,142,64,0,224,492,79,286,103,-78,-121,-823,165
21:12.0,17.5,524,454,549,390,105,78,142,64,0,224,501,95,396,103,-78,-121,-669,275
21:12.0,17.5,524,454,549,390,105,78,130,111,0,537,501,95,396,120,-19,-416,-339,-20
21:12.0,17.5,521,438,543,293,96,78,130,111,0,537,490,105,394,120,-19,-416,-222,-22
21:12.0,17.5,521,438,543,293,96,45,251,220,12,549,490,105,394,235,-31,-313,-83,81
21:12.1,17.6,521,438,543,293,96,27,365,275,53,528,490,105,394,320,-90,-208,21,186
21:12.1,17.6,514,339,501,193,102,27,365,275,53,528,420,162,318,320,-90,-208,186,110
21:12.1,17.6,489,216,351,131,111,27,365,275,53,528,283,135,172,320,-90,-208,375,-35
21:12.1,17.6,489,216,351,131,111,97,419,299,101,532,283,135,172,359,-120,-173,466,0
21:12.2,17.7,288,167,225,126,112,97,419,299,101,532,196,58,84,359,-120,-173,558,-89
21:12.2,17.7,288,167,225,126,112,159,448,336,175,517,196,58,84,392,-112,-125,650,-41
21:12.2,17.7,288,167,225,126,112,214,475,388,259,508,196,58,84,431,-87,-76,764,7
21:12.2,17.7,93,111,172,110,108,214,475,388,259,508,141,61,33,431,-87,-76,839,-43
21:12.3,17.8,93,111,172,110,108,248,494,421,311,507,141,61,33,457,-73,-49,916,-16
21:12.3,17.8,46,93,142,101,132,248,494,421,311,507,117,49,-14,457,-73,-49,925,-64
21:12.3,17.8,54,79,144,85,140,248,494,421,311,507,111,65,-28,457,-73,-49,939,-78
21:12.3,17.8,54,79,144,85,140,288,517,444,344,487,111,65,-28,480,-73,-6,975,-35
21:12.4,17.9,67,74,138,67,136,288,517,444,344,487,106,64,-30,480,-73,-6,1002,-36
21:12.4,17.9,67,74,138,67,136,313,535,462,366,458,106,64,-30,498,-73,40,1013,10
21:12.4,17.9,67,74,138,67,136,341,547,475,378,423,106,64,-30,511,-72,88,1003,58
21:12.4,17.9,67,70,127,52,129,341,547,475,378,423,98,57,-30,511,-72,88,1032,57
21:12.4,17.9,67,70,127,52,129,371,560,487,392,404,98,57,-30,523,-73,119,1040,89
21:12.4,17.9,68,65,122,47,123,371,560,487,392,404,93,57,-29,523,-73,119,1056,90
21:12.5,18,80,62,116,46,114,371,560,487,392,404,89,54,-25,523,-73,119,1070,94
21:12.5,18,80,62,116,46,114,400,568,496,404,390,89,54,-25,532,-72,142,1077,117
21:12.5,18,91,54,113,36,97,400,568,496,404,390,83,59,-13,532,-72,142,1109,128
21:12.5,18,91,54,113,36,97,428,580,514,413,379,83,59,-13,547,-66,168,1122,154
21:12.6,18.1,95,50,109,27,83,428,580,514,413,379,79,59,-3,547,-66,168,1149,164
21:12.6,18.1,95,50,109,27,83,451,595,521,416,334,79,59,-3,558,-74,224,1118,220
21:12.6,18.1,95,50,109,27,83,468,606,529,403,254,79,59,-3,567,-77,313,1035,310
21:12.6,18.1,86,52,87,17,155,468,606,529,403,254,69,35,-85,567,-77,313,983,228
21:12.7,18.2,86,52,87,17,155,496,617,541,322,104,69,35,-85,579,-76,475,763,389
21:12.7,18.2,71,56,77,18,488,496,617,541,322,104,66,21,-421,579,-76,475,432,53
21:12.7,18.2,126,142,106,87,531,496,617,541,322,104,124,-36,-407,579,-76,475,263,68
21:12.7,18.2,126,142,106,87,531,506,613,535,220,104,124,-36,-407,574,-78,470,156,63
21:12.8,18.3,126,142,106,87,531,509,539,492,102,106,124,-36,-407,515,-47,409,-18,2
21:12.8,18.3,236,209,212,141,542,509,539,492,102,106,210,3,-331,515,-47,409,-170,78
21:12.8,18.3,277,265,274,239,544,509,539,492,102,106,269,9,-274,515,-47,409,-329,135
21:12.8,18.3,277,265,274,239,544,507,430,383,70,111,269,9,-274,406,-47,295,-465,21
21:12.9,18.4,277,265,274,239,544,436,294,226,70,122,269,9,-274,260,-68,138,-600,-136
21:12.9,18.4,319,313,313,325,523,436,294,226,70,122,313,0,-210,260,-68,138,-709,-72
21:12.9,18.4,355,361,326,375,514,436,294,226,70,122,343,-35,-170,260,-68,138,-780,-32
21:12.9,18.4,355,361,326,375,514,252,182,177,61,125,343,-35,-170,179,-5,54,-867,-116
21:13.0,18.5,355,361,326,375,514,155,106,163,53,122,343,-35,-170,134,57,12,-923,-158
21:13.0,18.5,385,410,352,417,507,155,106,163,53,122,381,-58,-126,134,57,12,-995,-113
21:13.0,18.5,385,410,352,417,507,118,123,128,43,140,381,-58,-126,125,5,-14,-996,-140
21:13.0,18.5,401,439,394,456,496,118,123,128,43,140,416,-45,-79,125,5,-14,-1060,-94
21:13.0,18.5,410,455,412,480,470,118,123,128,43,140,433,-43,-36,125,5,-14,-1075,-51
21:13.1,18.6,410,455,412,480,470,102,148,114,28,144,433,-43,-36,131,-34,-13,-1080,-49
21:13.1,18.6,419,461,426,487,435,102,148,114,28,144,443,-35,8,131,-34,-13,-1062,-4
21:13.1,18.6,419,461,426,487,435,91,155,104,19,144,443,-35,8,129,-51,-14,-1073,-6
21:13.1,18.6,427,465,441,490,397,91,155,104,19,144,453,-24,56,129,-51,-14,-1047,41
21:13.2,18.7,427,465,441,490,397,88,162,87,14,137,453,-24,56,124,-75,-12,-1064,43
21:13.2,18.7,427,465,441,490,397,84,161,68,11,129,453,-24,56,114,-93,-14,-1085,41
21:13.2,18.7,433,468,457,494,375,84,161,68,11,129,462,-11,87,114,-93,-14,-1077,73
21:13.2,18.7,433,468,457,494,375,81,166,62,8,127,462,-11,87,114,-104,-13,-1082,74
21:13.3,18.8,443,476,473,502,349,81,166,62,8,127,474,-3,125,114,-104,-13,-1076,112
21:13.3,18.8,452,484,489,508,326,81,166,62,8,127,486,5,160,114,-104,-13,-1071,147
21:13.3,18.8,452,484,489,508,326,78,167,56,5,122,486,5,160,111,-111,-10,-1082,150
21:13.3,18.8,468,497,503,505,270,78,167,56,5,122,500,6,230,111,-111,-10,-1036,219
21:13.3,18.8,468,497,503,505,270,77,167,43,3,118,500,6,230,105,-124,-13,-1049,217
21:13.4,18.9,468,497,503,505,270,76,163,40,1,112,500,6,230,101,-123,-10,-1060,219
21:13.4,18.9,482,505,521,502,191,76,163,40,1,112,513,16,322,101,-123,-10,-991,311
21:13.4,18.9,482,505,521,502,191,74,137,42,0,125,513,16,322,89,-95,-35,-991,286
21:13.4,18.9,497,514,545,489,127,74,137,42,0,125,529,31,402,89,-95,-35,-931,367
21:13.5,19,497,514,545,489,127,71,125,69,0,510,529,31,402,97,-56,-413,-538,-10
21:13.5,19,504,515,564,435,64,71,125,69,0,510,539,49,475,97,-56,-413,-431,62
